Good job!	خدما مليحا.
Thank you.	يعطيك الصحة.
I have won.	ربحت.
I ran home.	هربت لدّار.
Tom's dead.	مات طوم.
We are men.	حنايا رجال.
How are you?	Wech rak?
We need you.	نسحقُّوك.
Why not both?	وعلاش ماشي في زوج؟
I hate French.	نكره لفرنسي.
That's my cat.	هادا لقط ديالي.
That's my cat.	هادا لقط تاعي.
That's my cat.	هادي لقطّا ديالي.
That's my cat.	هادي لقطّا تاعي.
Tom's smiling.	طوم راو يبتسم.
Did you see it?	شفتها؟
Did you see it?	شفتو؟
I'm making tea.	راني ندير فلاتاي.
Open the doors.	افتح لبيبان.
Open the doors.	افتحو لبيبان.
I think so, too.	حتانا بانتلي هاكدا.
I think so, too.	حتانا نشك هاكدا.
She forgave him.	سمحتلو.
There she comes.	هايليك راي جايا.
This is a horse.	هادا عود.
What's her name?	وسّمها؟
What's his name?	وسمو؟
Did you have fun?	عجبكم لحال؟
Did you see that?	شفت هادا؟
Did you see that?	شفت هادي؟
Have you seen it?	شفتها؟
Have you seen it?	شفتو؟
I'm 25 years old.	في عمري 25 سنا.
What could it be?	وش يقدر ايكون.
What could it be?	وش تقدر تكون.
What's your name?	وسمك؟
Have you seen her?	شفتها؟
His story is true.	حكايتو كاين منها.
I have a computer.	عندي ميكرو.
The house is cold.	ادّار راي باردا.
Tom gave me a pen.	طوم أطالي كريُّون.
We're old friends.	حنا صحاب قدم.
We're old friends.	حنا حباب قدم.
What is your name?	وسمك؟
You had better go.	روح خيرلك.
Can I use your pen?	نقدر نستعمل ستيلو ديالك.
Can you wait a bit?	تقدر تسنّا شويّا.
Can you wait a bit?	تقّدري تسنّاي شويّا.
Can you wait a bit?	تقدّرو تسنّاو شويّا.
Don't be so stupid.	ماتكونش جايح.
Don't be so stupid.	ماتكونش بهلول.
How did he find us?	كيفاش لقانا؟
I corrected myself.	صحَّحت روحي.
She is about forty.	عندها قريب ربعين سنا في عمرها.
Can you rub my back?	تقدر تحكلي دهري.
Can you rub my back?	تقدري تحكِّيلي دهري.
I can survive alone.	ما نقدرش نعيش وحدي.
I pretended to work.	كونت ندير روحي نخدم.
I pretended to work.	كونت داير روحي نخدم.
Did you win the race?	ربحت لاكورس.
It's not their fault.	ماشي لغلطا ديالهم.
May I have your name?	تقدر تقولِّي وسمك؟
Sumatra is an island.	سوماترا جزيرا.
We didn't do a thing.	مادرنا والو.
Who did you vote for?	عليمن فوطيت.
Why do you work here?	علاش تخدم هنا.
Call me at the office.	عيّطلي فلبيرو.
Can I turn off the TV?	نقدر نطفي تلفزيون؟
Can I use your pencil?	نقدر نستعمل لقلم ديالك.
He crossed the street.	قطع طريق.
I am tired of my work.	عييت ملخدما ديالي.
May I use your pencil?	نقدر نستعمل لقلم ديالك.
Don't be overconfident.	ما تكونش واتق بزّاف منفسك.
He wasn't ready for it.	ماكانش واجدلها.
It's fairly warm today.	الحال شوية سخون اليوم.
Take your hands off me!	نحِّي يدّك عليّا.
This is the last train.	هادي هيّا لماشينا لّخرا.
What're we waiting for?	واش رانا نستنّاو؟
Could I use your pencil?	نقدر نستعمل لقلم ديالك.
I always walk to school.	دايما نروح لّمسيد نمشي.
I have bad news for you.	عندي خبر عيّان ليك.
It's not the first time.	ماشي لمرَّا لّولا.
The price is reasonable.	سوما معقولا.
They are making a salad.	راهم ايديرو فشلاضا
Tom told you, didn't he?	طوم لّيقالك، ولاّ لالا؟
Why didn't you stop them?	وعلاش ما حبستهومش؟
I don't want to be a hero.	مارانيش حاب نكون بطل.
I have to make some calls.	لازم نتيليفوني.
It is nice and warm today.	لحال راو شباب اودافي ليوم.
There are almost no books.	قريب ماكاين حتى كتاب.
Where are you going to go?	وين راك رايح تروح.
Where are you going to go?	وين راكم رايحين تروحو.
Where are you going to go?	وين راكي رايحا تروحي.
He seems to be very sleepy.	ايبان راو نعسان بزّاف.
I think you'd better leave.	نضن تعمل مليح لوكان تروح.
We have no school tomorrow.	غدوا ما نقراوش.
What time did Tom get here?	علاقدّاش لحق طوم لّهنا.
Are you going by bus or car?	تروح فلكار ولا فطونوبيل.
Are you going by bus or car?	تروحي فلكار ولا فطونوبيل.
Are you going by bus or car?	تروحو فلكار ولا فطونوبيل.
I saw Tom a few minutes ago.	شفت طوم عندها شي دقايق.
My father has gone to China.	بابا راح لشِّين.
We don't know our neighbors.	ما نعرفوش جيرانّا.
I want you to read this book.	راني حابّك تقرى هاد لكتاب.
The apple has begun to decay.	هاد التّفاحا بدات ترشا.
This hat is too tight for me.	تشابونا هادي مزيرا بزاف على راسي.
I always go to school on foot.	دايما نروح لّمسيد على رجليا.
I just want to go back to bed.	راني حاب برك نولّي لفراش.
My father cut wood with a saw.	بابا قطّع لحطب بالمنشار
My sister is shorter than you.	ختي قصيرا عليك.
She left school two years ago.	خرجت ملمسيد عندها عامين.
What would you like Tom to do?	واش راك حاب ايدير طوم؟
I think Tom was born in Boston.	نضن طوم زاد في بوسطن.
I think we're going to be late.	نضن رانا رايحين نكونو متأخرين.
The ghost story was terrifying.	لحكايا تع لغول تخوف.
The ghost story was terrifying.	لحكايا تع لغول تخلع.
Are you busy tomorrow afternoon?	راك محكوم غدوا لعشيّا؟
I used to be the same age as you.	كنت قدّك.
He was sitting beside his brother.	كان قاعد قدّام خوه.
She is able to speak ten languages.	تقدر تهدر عشرا لوغات.
He seems to be aware of my feelings.	ايبان راو واعي بواش راني نحّس.
I can't imagine my life without you.	ما نقدرش نخايل حياتي بلا بيك.
I taught Tom French three years ago.	عندها تلت سنين قريت طوم لفرنسي.
I think that Tom was born in Boston.	نضن طوم زاد في بوسطن.
After lunch we have two more classes.	مور لفطور عندنا زوج دروس.
I have not heard from her for a month.	عندي شهر ما سمعتش عليها.
I think I know what Tom is doing here.	نضن علابالي وش كان ايدير هنا طوم.
My sister always keeps her room clean.	ختي دايمن تخلِّي لبِيت ديالها نقِيا.
He went up to her and they shook hands.	دنّا ليها وخمس معاها.
Many people have made the same mistake.	بزاف ناس دارو نفس الغلطة.
It was found at the bottom of the river.	لقاوه فقاع لواد.
It was found at the bottom of the river.	لقاوها فقاع لواد.
He is slowly recovering from his illness.	راو يبرا بلعقل ملمرض ديالو.
He left the room as soon as I entered it.	غير دخلت لشّمبرا خرج.
He left the room as soon as I entered it.	غير دخلت للبيت خرج.
I don't understand a thing you're saying.	ما فهمت والوا فواش راك تقول.
I'm not satisfied with the result at all.	ماهوش عاجبني لحال كامل بالنتيجا.
The school is closed because of the snow.	لمسيد راو مغلوق علا جال التلج.
Did you see him while you were at Lambton?	شفتو كي كنت فلامبطون؟
I am not satisfied with the result at all.	ماهوش عاجبني لحال كامل بالنتيجا.
I wonder why we play tennis in miniskirts.	مانيش فاهم علاش يلعبو تينيس بلميني.
Tom is standing in the corner of the room.	طوم راو واقف فلكوانا تع اشّومبرا.
Tom is standing in the corner of the room.	طوم راو واقف فلكوانا تع لبيت.
If he studied hard, he would pass the test.	لُواكن يقرا مليح، يقدر ايجيب ليختيبار ديالو.
It's too late to do anything about that now.	طروطار درك، ما نقدرو نديرو والو.
He crushed the sheet of paper up into a ball.	كرفس الورقا أو دار بيها بولا.
I'm going to go to the doctor this afternoon.	راني رايح نروح لطبيب هاد لعشيّا.
He cared for his mother after his father died.	كان لاتي بيمّاه مور ما مات باباه.
She was born with a silver spoon in her mouth.	زادت بمغرفا تع لفضا في فمها.
I pretended not to understand what he was saying.	درت روحي مافهمتش واش كان إيقول.
I will tell him about it when he comes next time.	نقولّو عليها كيجي لمرّا لجايا.
She was ready to help him with cleaning the house.	كانت واجدا باش تعاونهم بش إينقِّيو ادّار.
I'm calling because my credit card has been stolen.	عيّطت علاخاطرش سرقولي لكارت كريدي.
If it were not for water, no living things could live.	لوكان ماكانش كاين الما، حتى حاجا ما تقدر تعيش.
The police seized a large quantity of drugs at the school.	لابوليس سيزاو كانتيتي كبيرا تع الزطلا فلمسيد.
They wanted a wedding picture in front of the Eiffel Tower.	حبو ياخدو تصويرا تع الزواج ديالهم قدام لاتوريفال.
