Go.	Idi.
Run!	Trči!
Run!	Bježi!
Who?	Ko?
Duck!	Čučni!
Fire!	Požar!
Help!	Upomoć!
Hide.	Sakrij se.
Jump.	Skok.
Jump.	Skoči!
Stay.	Ostani.
Stop!	Stani!
Stop!	Dosta!
Wait!	Čekaj!
Wait.	Čekaj.
Begin.	Počni.
Hurry!	Požuri!
Relax.	Opusti se.
Shoot!	Pucaj!
Smile.	Nasmij se.
Sorry?	Oprosti?
Sorry?	Oprostite?
Attack!	U napada!
Cheers!	Živjeli!
Cheers!	Živio!
Freeze!	Stoj!
Listen.	Slušaj.
No way!	Nema šanse!
No way!	Nikako!
Really?	Stvarno?
Thanks!	Hvala!
Awesome!	Odlično!
Get out.	Izađi.
Perfect!	Savršeno!
Welcome.	Dobrodošli.
Welcome.	Dobrodošao.
Have fun.	Lijepo se provedi.
Hurry up.	Požuri.
Look out!	Pazi!
Terrific!	Sjajno!
Too late.	Kasno.
Too late.	Prekasno.
Fantastic!	Fantastično!
Forget it.	Zaboravi.
I fainted.	Onesvijestio sam se.
I fainted.	Izgubio sam svijest.
Seriously?	Ozbiljno?
Take care.	Čuvaj se.
Take care.	Čuvajte se.
Wonderful!	Predivno!
You tried.	Pokušao si.
Bottoms up!	Na iskap!
Definitely!	Definitivno!
Never mind!	Nema veze!
Never mind!	Ne brini!
Money talks.	Novac vodi riječ.
Nobody came.	Niko nije došao.
Fish, please.	Ribu, molim.
Please hurry.	Molim te požuri.
Please hurry.	Molim Vas požurite.
Unbelievable!	Nevjerovatno!
Check, please.	Račun, molim.
Happy birthday!	Sretan rođendan!
Stop grumbling.	Prestani gunđati.
Congratulations!	Čestitam!
Merry Christmas!	Srećan Božić!
Remove your hat.	Skini kapu.
Come to my house.	Dođi kod mene kući.
Come to my house.	Dođi u moju kuću.
Come to my house.	Dođi mojoj kući.
It was destroyed.	Uništeno je.
We heard her cry.	Čuli smo je kako plače.
We heard her cry.	Čuli smo da ona plače.
Tom became a hero.	Tom je postao heroj.
Tom seemed annoyed.	Tom je djelovao iznervirano.
Come again any time.	Dođi opet bilo kada.
I finally got a job.	Konačno sam dobio posao.
We can depend on Tom.	Možemo se osloniti na Toma.
What a wonderful day!	Kakav divan dan!
What would Tom think?	Šta bi Tom pomislio?
What would Tom think?	Šta bi Tom mislio?
I hope that's the truth.	Nadam se da je to istina.
We'll fight to the last.	Borićemo se do zadnjeg.
What does he mean to do?	Šta želi on da uradi?
I regard him as an enemy.	Ja njega smatram za neprijatelja.
I regard him as an enemy.	Smatram ga neprijateljom.
The house is owned by him.	Kuća je u njegovom posjedstvu.
We went in search of gold.	Otišli smo u potragu za zlatom.
Maybe Tom can speak French.	Možda Tom zna francuski.
Maybe Tom can speak French.	Možda Tom zna da priča francuski.
How did you accomplish this?	Kako si ovo uspio?
How did you accomplish this?	Kako si uspio da ostvariš ovo?
My family are all very well.	Svi u mojoj porodici su dobro.
Tom looks totally wiped out.	Tom izgleda potpuno uništeno.
Tom says he wants to change.	Tom kaže da želi da se promijeni.
I don't like to be surprised.	Ne volim da se iznenadim.
We saw another ship far away.	Vidjeli smo još jedan brod u daljini.
Tom couldn't finish his lunch.	Tom nije mogao da završi svoj ručak.
Tom couldn't finish his lunch.	Tom nije mogao da završi ručak.
Tom knew Mary didn't like him.	Tom je znao da se ne sviđa Mariji.
Tom knew Mary didn't like him.	Tom je znao da ga Marija ne voli.
We discussed our future plans.	Razgovarali smo o planovima za budućnost.
We sang as loudly as we could.	Pjevali smo glasno koliko smo mogli.
We're anxious about her health.	Zabrinuti smo za njeno zdravlje.
We've had bad weather recently.	Imali smo loše vrijeme nedavno.
French isn't my native language.	Francuski nije moj maternji jezik.
I doubt if Tom will be truthful.	Sumnjam da će Tom biti iskren.
Tom rarely eats with his family.	Tom rijetko jede sa svojom porodicom.
Tom told me to knock on the door.	Tom mi je rekao da pokucam na vrata.
We objected, but Tom left anyway.	Protivili smo se, ali Tom je otišao svakako.
Are Tom and Mary in Australia now?	Da li su sada Tom i Marija u Australiji?
Insofar as we know, Tom is guilty.	Koliko znamo do sada, Tom je kriv.
Tom can be trusted to some degree.	Tomu se može vjerovati donekle.
Tom isn't here. He's already left.	Tom nije ovde. Već je otišao.
Tom wasn't able to shoot the deer.	Tom nije mogao da upuca jelena.
We went as far as Boston together.	Išli smo sve do Bostona zajedno.
We're engaged in a difficult task.	Uljučeni smo u težak zadatak.
I wanted to help Tom pay his bills.	Želio sam da pomognem Tomu da plati račune.
I'm sure the two of you will agree.	Siguran sam da ćete se vas dvoje složiti.
I'm sure the two of you will agree.	Siguran sam da ćete se vas dvojica složiti.
That's the book I bought yesterday.	To je knjiga koju sam kupio juče.
The storm shouldn't affect our plans.	Oluja ne bi trebala da utiče na naše planove.
We can't follow your plan any longer.	Ne možemo više da pratimo tvoj plan.
We learn to read and write in school.	Učimo da čitamo i pišemo u školi.
We learn to read and write in school.	U školi učimo da čitamo i pišemo.
We must obey the traffic regulations.	Moramo poštovati pravila saobraćaja.
We must obey the traffic regulations.	Moramo poštovati saobraćajna pravila.
We'll get through the jungle somehow.	Nekako ćemo proći kroz džunglu.
We'll get through the jungle somehow.	Proćićemo kroz džunglu nekako.
I can't give you an answer right away.	Ne mogu ti odgovoriti odmah.
I told Tom that you were in Australia.	Rekao sam Tomu da si u Australiji.
She was educated in the United States.	Ona se školovala u Sjedinjenim Američkim Državama.
She was educated in the United States.	Ona je školovana u Sjedinjenim Državama.
This phone isn't working as it should.	Ovaj telefon ne radi kako bi trebao.
I don't know why I even bother anymore.	Ne znam zašto se uopšte više brinem.
I don't know why I even bother anymore.	Ne znam zašto više obraćam pažnju uopšte.
There's a party at Tom's house tonight.	Parti je u Tomovoj kući večeras.
Tom is listening to his phone messages.	Tom preslušava svoje poruke na telefonu.
Have you tried restarting your computer?	Da li si probao da ponovo pokreneš računar?
Have you tried restarting your computer?	Da li ste probali da ponovo pokrenete računar?
I've been sick in bed since last Monday.	Ležim bolestan u krevetu još od prošlog ponedeljka.
We had a serious conversation about that.	Imali smo ozbiljan razgovor o tome.
What I want now is a glass of cold water.	Ono što želim sada je čaša hladne vode.
This phone isn't working the way it should.	Ovaj telefon ne radi na način kako bi trebao.
We'll discuss the problem with them tomorrow.	Sutra ćemo razgovarati sa njima o problemu.
I don't think you need to tell Tom what to do.	Mislim da ne treba da govoriš Tomu šta da radi.
I wonder if Tom likes dancing as much as Mary.	Pitam se da li Tom voli plesanje koliko Marija.
I've been to more than ten foreign countries so far.	Bio sam u više od deset stranih država do sada.
I didn't know that soccer was such a dangerous sport.	Nisam znao da je fudbal tako opasan sport.
Tom asked Mary some questions that she couldn't answer.	Tom je pitao Mariju neka pitanja na koja ona nije mogla da odgovori.
Tom asked Mary some questions that she couldn't answer.	Tom je postavio Mariji neka pitanja na koja ona nije mogla odgovoriti.
