Thanks!	Grazas.
It rained.	Choveu.
Turn left.	Vira á esquerda.
I'm a hero.	Son un heroe.
Don't worry.	Non vos preocupedes.
I like cats.	Gústanme os gatos.
I'm thirsty.	Teño sede.
Surprise me.	Sorpréndeme.
He has a dog.	El ten un can.
I called him.	Chameino a el.
I'm divorced.	Estou divorciada.
I am all ears.	Son todo ouvidos.
We're enemies.	Somos inimigos.
Good afternoon.	Boas tardes.
It is Saturday.	É sábado.
It's very cold.	Fai moito frío.
Open your eyes.	Abre os ollos.
Open your eyes.	Abride os ollos.
The tea is hot.	O té está quente.
Drive carefully.	Conduce con xeito.
His name is Tom.	El chámase Tom.
How old are you?	Cantos anos tes?
I can't hear it.	Non podo o ouvir.
I have brothers.	Teño irmáns.
I have two cats.	Teño dous gatos.
I'll buy a Ford.	Hei mercar un Ford.
I agree with you.	Estou de acordo contigo.
It's really cold.	Fai moito frío.
No one likes war.	A ninguén lle gusta a guerra.
She worships him.	Ela adórao.
Tom was our hero.	Tom era o noso heroe.
We're in a hurry.	Temos présa.
We're in a hurry.	Temos apuro.
What's your name?	Como te chamas?
Christmas is near.	O Nadal está cerca.
Keep away from me.	Arrédate de min.
Tom is a good boy.	Tom éche un bo rapaz.
What is your name?	Como te chamas?
Where do you live?	Onde vives?
You have no heart.	Non tes corazón.
He wants a new car.	El quere un coche novo.
I sleep in my room.	Eu durmo na miña habitación.
I want to be happy.	Quero ser feliz.
I watch television.	Vexo a televisión.
It wasn't my fault.	Non foi miña culpa.
Just water, please.	Só auga, por favor.
That house is mine.	Aquela casa é miña.
The signal was red.	O semáforo estaba en vermello.
What are you doing?	Que fas?
Why are you crying?	Por que estás a chorar?
Do you drink coffee?	Bebedes café?
Have a nice weekend.	Ten unha boa fin de semana.
I can't find my key.	Non dou topado a miña chave.
I told you to leave.	Díxenche que marcharas.
I'll make you happy.	Fareite feliz.
May I ask your name?	Podo preguntarlle o seu nome?
More coffee, please.	Máis café, por favor.
She is on death row.	Ela está no corredor da morte.
Take it or leave it.	Colles ou largas.
That's not possible.	Iso non é posíbel!
Those are our books.	Aqueles son os nosos libros.
Tom put on his robe.	Tom puxo a súa sotana.
Tom was very scared.	Tom estaba moi asustado.
We had an oral exam.	Tivemos un exame oral.
Welcome to our home.	Benvido ao noso lar.
Welcome to our home.	Benvido ao noso fogar.
Will you forgive me?	Perdóasme?
He has two daughters.	El ten dúas fillas.
He was badly wounded.	Foi gravemente ferido.
How many do you need?	Cantos precisas?
How much is this tie?	Canto custa esta gravata?
I've got a good idea.	Teño unha boa idea.
They're already here.	Eles xa están aquí.
Turtles are reptiles.	As tartarugas son réptiles.
A week has seven days.	Unha semana ten sete días.
Are you talking to me?	Falas comigo?
Do you have some milk?	Ten vostede algo de leite?.
He started a new life.	El comezou unha nova vida.
He talked about music.	El falou de música.
I don't have any pens.	Non teño ningún bolígrafo.
I don't need anything.	Non preciso nada.
I need it by tomorrow.	Necesítoo para mañá.
It's not worth trying.	Non paga a pena intentalo.
She always works hard.	Ela sempre traballa moito.
She is afraid of dogs.	Ela tenlle medo aos cans.
Tom got off the plane.	Tom baixou do avión.
We have two daughters.	Temos dúas fillas.
Where are your things?	Onde están as túas cousas?
Are you speaking to me?	Falas comigo?
I knew he would accept.	Sabía que el aceptaría.
This is not a sentence.	Isto non é unha frase.
Are you drinking coffee?	Bebedes café?
Are you working tonight?	Traballas esta noite?
I hardly have any money.	Apenas teño cartos.
I'll be back in an hour.	Volvo nunha hora.
You can swim, can't you?	Sabes nadar, non si?
A year has twelve months.	Un ano ten doce meses.
He dressed up as a woman.	Vestiuse coma unha muller.
I can't accept this gift.	Non podo aceptar este agasallo.
I eat eggs every morning.	Como ovos tódalas mañás.
I won't go till tomorrow.	Non irei ata mañá.
I'm too busy to help him.	Estou moi ocupado como para axudalo.
The snow has disappeared.	A neve desapareceu.
The snow started to melt.	A neve empezou a derreterse.
These books are very old.	Estes libros son moi vellos.
He always tells the truth.	El sempre di a verdade.
He took poison by mistake.	El tomou veleno por erro.
I'm waiting for the train.	Estou agardando o tren.
One plus two equals three.	Un máis dous é igual a tres.
The bedrooms are upstairs.	Os dormitorios están enriba.
Tom finally ate something.	Tom finalmente comeu algo.
Who painted this painting?	Quen pintou ese cadro?
He shaved his mustache off.	Afeitou o bigote.
He told her about his plan.	Faloulle a ela do seu plan.
I can easily touch my toes.	Podo tocar doadamente os meus dedos dos pés.
I'll call tomorrow morning.	Chamarei mañá á mañá.
This dictionary isn't mine.	Este dicionario non é meu.
What did you do last night?	Que fixeches onte pola noite?
Hardly anyone was satisfied.	Case ninguén quedou satisfeito.
I don't know where he lives.	Non sei onde reside.
I have a suggestion for you.	Teño unha suxestión para ti.
I wish you were close to me.	Ogallá estiveses preto de min.
Is there a telephone nearby?	Hai un teléfono preto?
The wound hasn't healed yet.	A ferida non cicatrizou aínda.
He was the man of her dreams.	Era o home dos seus soños.
The bucket was full of water.	O caldeiro estaba cheo de auga.
The bucket was full of water.	O balde estaba cheo de auga.
He is the man you can rely on.	El é o home no cal ti podes confiar.
He plays the guitar very well.	El toca moi ben a guitarra.
He slept with the window open.	El durmiu coa fiestra aberta.
How many siblings do you have?	Cantos irmáns tendes?
I know you're going to say no.	Sei que vas dicir non.
She insisted on her innocence.	Ela insistiu na súa inocencia.
The food isn't very good here.	A comida de aquí non é moi boa.
That was an unforgivable error.	Ese foi un erro imperdoábel.
There's no reason to be afraid.	Non hai por que ter medo.
There's nobody at the entrance.	Non hai ninguén na entrada.
Children often swim in the lake.	Os rapaces a menudo nadan no lago.
Have you read today's paper yet?	Liches xa o xornal de hoxe?
I know that Tom is a pharmacist.	Sei que o Tom é farmacéutico.
I'm going to put a stop to this.	Vou deter isto.
Please come as soon as possible.	Por favor, ven tan axiña como sexa posíbel.
Tom doesn't want to go home now.	Tom non quere ir para casa agora.
Could I see the schedule, please?	Podería mirar o horario, por favor?
I don't want crumbs on the table.	Non quero migallas sobre a mesa.
I was too tired to go on working.	Eu estaba demasiado canso para continuar traballando.
She turned away and began to cry.	Ela virouse e comezou a chorar.
The smell of food made me hungry.	O olor da comida deume fame.
The traffic light changed to red.	O semáforo mudou a vermello.
All the apple trees were cut down.	Todas as maceiras foron pinchadas.
He is still too young for the job.	El aínda é moi novo para este traballo.
It's too bad you can't come today.	É unha mágoa que non poidas vir hoxe.
To make money one must want money.	Pra facer cartos, un primeiro ten que desexa-los cartos.
We found a nail stuck in the tire.	Atopamos un cravo espetado no pneumático.
A cat came out from under the desk.	Un gato saíu de abaixo do escritorio.
A cat came out from under the desk.	Un gato saíu de embaixo do escritorio.
Tell me how you solved the problem.	Cóntame como solucionaches o problema.
You should have accepted his advice.	Debiches acepta-lo seu consello.
If he comes, tell him to wait for me.	Se vén, dille que agarde por min.
My parents want me to study medicine.	Os meus pais queren que estude medicina.
She stirred the milk into her coffee.	Ela mesturou o leite co café.
Do you need me to give you some money?	Precisas que che dea algo de cartos?
I have two brothers and three sisters.	Teño dous irmáns e tres irmás.
She reads the newspaper every morning.	Ela le o xornal cada mañá.
This could be done in one or two days.	Iso poderíase facer nun ou dous días.
An eye for an eye, a tooth for a tooth.	Ollo por ollo, dente por dente.
December is the last month of the year.	Decembro é o último mes do ano.
Nobody told me what time I should come.	Ninguén me dixo cando tiña que vir.
The soldiers resisted the enemy attack.	Os soldados resistiron o ataque do inimigo.
He stood by me whenever I was in trouble.	El estivo ao meu carón sempre que eu tiña problemas.
Someone must have left the water running.	Alguén debeu deixa-la auga a correr.
They stopped their game and stared at me.	Eles detiveron o seu xogo e ollaron en fite para min.
The United States became a nation in 1776.	Os Estado Unidos convertéronse nunha nación en 1776.
Would you have time to have lunch with me?	Terás tempo pra comer comigo?
We are going to visit our aunt next Sunday.	O domingo que vén iremos visita-la nosa tía.
This is the last opportunity I'm giving you.	Esta é a derradeira oportunidade que che dou.
There is a TV remote control under the couch.	Hai un mando a distancia debaixo do sofá.
We are always exposed to some kind of danger.	Sempre estamos expostos a algún tipo de perigo.
Write your name and address on this envelope.	Escribe o teu nome e enderezo neste sobre.
I'm getting off the train at the next station.	Báixome do tren na próxima estación.
In Japan, the new school year begins in April.	No Xapón o ano novo escolar comeza en abril.
Nuclear energy is used to produce electricity.	A enerxía nuclear emprégase para producir electricidade.
The trouble with him is that he is not punctual.	O seu problema é que non é puntual.
If you go to the movies, take your sister with you.	Se vas ao cine, leva a túa irmá.
She enjoyed herself very much at the party yesterday.	Ela divertiuse moito na festa de onte.
This is the first airplane to land at the new airport.	Este é o primeiro avión a desembarcar no novo aeroporto.
Country life is very peaceful in comparison with city life.	A vida no campo é moi tranquila en comparación coa vida na cidade.
When you're done with the book, put it back where you found it.	En rematando co libro, volve pólo onde o atopaches.
Thousands of candles illuminated the church during the ceremony.	Milleiros de candeas alumaban a igrexa durante a cerimonia.
