What's up?	ಆರಾಮಾ?
How are you?	ಹೇಗಿದ್ದೀರ
Tom woke up.	ಟಾಮ್ ಏಳಿದನು.
Give me half.	ಅರ್ಧ ನನಗೆ ಕೊಡು.
We needed it.	ನಮಗೆ ಬೇಕಾಗಿತ್ತು.
I'm very busy.	ನಾನು ತುಂಬಾ ಬಿಝಿ
Tom liked you.	ಟಾಮ್ ನಿನ್ನನ್ನು ಬಯಸಿದನು.
Just go inside.	ಒಳಗೆ ಹೋಗು ಅಷ್ಟೇ.
Do you remember?	ನಿಮಗೆ ನೆನಪು ಇದ್ಯಾ?
I just got back.	ನಾನು ಈಗ ತಾನೇ ವಾಪಸ್ಸು ಬಂದೆ.
See you at 2:30.	ಎರಡು ವರೆಗೆ (೨.೩೦ ಗೆ) ನಿನ್ನನ್ನು ನೋಡುತ್ತೇನೆ.
Can we go inside?	ನಾವು ಒಳಗಡೆ ಹೋಗಬಹುದಾ?
I believe in you.	ನಾನು ನಿನ್ನ ಮೇಲೆ ನಂಬಿಕೆ ಇಟ್ಟಿದ್ದೇನೆ.
Mary is gorgeous.	ಮೇರಿ ಸೌಂದರ್ಯವಾಗಿದ್ದಾಳೆ.
How's your family?	ನಿಮ್ಮ ಮನೇಲಿ ಹೆಂಗಿದ್ದಾರೆ
Where is the book?	ಪುಸ್ತಕ ಎಲ್ಲಿದೆ?
Tom stayed with me.	ಟಾಮ್ ನನ್ನ ಜೊತೆ ಉಳಿದುಕೊಂಡನು.
Don't let Tom do it.	ಟೊಮನ್ನು ಅದನ್ನು ಮಾಡಕ್ಕೆ ಬಿಡಬೇಡಿ.
They're useless now.	ಅವರು ಏನಕ್ಕೂ ಉಪಯೋಗವಿಲ್ಲ.
We're working on it.	ನಾವು ಅದರ ಕುರಿತು ಕೆಲಸ ಮಾಡುತ್ತಾ ಇದ್ದೇವೆ.
I traveled by myself.	ನಾನು ಒಂಟಿಯಾಗಿ ಪಯಣ ಮಾಡಿದೆ.
Tom is very careless.	ಟಾಮ್ ತುಂಬಾನೇ ಅಸಡ್ಡೆ.
What's going on here?	ಇಲ್ಲಿ ಏನು ನಡಿತಾಯಿದೆ?
You have to tell Tom.	ನೀವು ಟಾಮಿಗೆ ಹೇಳಲೇಬೇಕು.
You let me down, Tom.	ನೀನು ನನ್ನನು ನಿರಾಶೆ ಮಾಡುತ್ತೀಯ.
Did Tom ever hurt you?	ಟಾಮ್ ನಿನ್ನನ್ನು ಯಾವಾಗಲಾದರೂ ನೋಯಿಸಿದ್ದಾನಾ?
I gave Tom a huge hug.	ನಾನು ಟೊಮನ್ನು ಬಿಗಿಯಾಗಿ ತಬ್ಬಿಕೊಂಡೆ.
That's all Tom needed.	ಅದಷ್ಟೇ ಟಾಮಿಗೆ ಬೇಕಾಗಿದ್ದು.
I must be getting home.	ನಾನು ಮನೆಗೆ ಹೊರಡುತ್ತಾ ಇರಬೇಕು.
I think that went well.	ಚನ್ನಾಗಿ ನಡೆಯಿತು ಅಂತ ಅನಿಸುತ್ತೆ.
Let's greet our guests.	ನಮ್ಮ ಅತಿಥಿಗಳನ್ನು ಸ್ವಾಗತಿಸೋಣ.
Stupidity is no excuse.	ಮೂರ್ಖತನಕ್ಕೆ ಯಾವ ಕ್ಷಮೆಯು ಇಲ್ಲ.
You need to stay awake.	ನೀವು ಎಚ್ಚರವಾಗಿರಬೇಕು.
Eat a lot of vegetables.	ಬಹಳ ತರಕಾರಿಗಳು ತಿನ್ನು.
I had to get some money.	ನಾನು ಸ್ವಲ್ಪ ದುಡ್ಡನ್ನು ತೆಗೆದುಕೊಂಡು ಬರಬೇಕಾಗಿತ್ತು.
I only wish to help you.	ನಿಮ್ಮನ್ನು ಸಹಾಯ ಮಾಡುವುದಕ್ಕೆ ಆಶಿಸುತ್ತೇನೆ.
Why are you thanking me?	ನೀವು ಯಾಕೆ ನನಗೆ ಧನ್ಯವಾದ ಹೇಳುತ್ತೀರಾ?
He swam across the river.	ಅವನು ನದಿ ಅಡ್ಡಲಾಗಿ ಈಜಿದನು.
How did it go last night?	ನೆನ್ನೆ ರಾತ್ರಿ ಹೇಗೆ ನಡೆಯಿತು?
I've never been to Paris.	ನಾನು ಪ್ಯಾರಿಸಿಗೆ ಎಂದಿಗೂ ಹೋಗಿಲ್ಲ.
Tom had almost forgotten.	ಟಾಮ್ ಬಹುಮಟ್ಟಿಗೆ ಮರೆತುಬಿಟ್ಟಿದ್ದನು.
Tom is a real competitor.	ಟಾಮ್ ಒಬ್ಬ ಒಳ್ಳೆಯ ಪ್ರತಿಸ್ಪರ್ಧಿ.
Tom is ready for you now.	ಟಾಮ್ ಈಗ ನಿಮಗೆ ತಯಾರಾಗಿದ್ದಾನೆ.
Tom left three hours ago.	ಟಾಮ್ ಮೂರು ಗಂಟೆಯ ಮುಂಚೇನೇ ಹೋದ.
Tom told Mary to go home.	ಟಾಮ್ ಮೇರಿಗೆ ಮನೆಗೆ ಹೋಗುವುದಕ್ಕೆ ಹೇಳಿದನು.
You are in love with him.	ನೀನು ಅವನನ್ನು ಪ್ರೀತಿಸುತ್ತಿದ್ದೀಯ.
He agrees with my opinion.	ಅವನು ನನ್ನ ಅಭಿಪ್ರಾಯವನ್ನು ಸಮ್ಮತಿಸುತ್ತಾನೆ.
He goes abroad every year.	ಪ್ರತಿವರ್ಷ ಅವನು ವಿದೇಶಕ್ಕೆ ಹೋಗುತ್ತಾನೆ.
How did you get that scar?	ಆ ಗಾಯ ಹೇಗೆ ಸಿಕ್ಕಿತು?
I've always believed that.	ನಾನು ಎಂದಿಗೂ ಅದನ್ನೇ ನಂಬಿದ್ದೇನೆ.
Last night, I read a book.	ನೆನ್ನೆ ರಾತ್ರಿ ನಾನು ಒಂದು ಪುಸ್ತಕವನ್ನು ಓದಿದೆ.
One of us will have to go.	ನಮ್ಮಲ್ಲಿ ಒಬ್ಬರು ಹೋಗಲೇ ಬೇಕಾಗುತ್ತದೆ.
The war is still going on.	ಯುದ್ಧ ಇನ್ನೂ ನಡೆಯುತ್ತಿದೆ.
The weather is nice today.	ಇವತ್ತು ವೆದರ್ ಚೆನ್ನಾಗಿದೆ
Tom doesn't eat much meat.	ಟಾಮ್ ಹೆಚ್ಚು ಮಾಂಸ ತಿನ್ನುವುದಿಲ್ಲ.
We were caught in a storm.	ನಾವು ಬಿರುಗಾಳಿಯಿಂದ ಸಿಕ್ಕಿಹಾಕಿಕೊಳ್ಳಿದ್ದೆವಿ.
What team do you play for?	ನೀವು ಯಾವ ತಂಡಕ್ಕೆ ಆಟ ಆಡುತ್ತೀರಾ?
You shouldn't be here now.	ನೀವು ಇಲ್ಲಿ ಈಗ ಇರಬಾರದು.
He had an accident at work.	ಕೆಲಸದಲ್ಲಿ ಅವನಿಗೆ ಅಪಘಾತವಾಯಿತು.
I loved going to the beach.	ನಾನು ದಡಕ್ಕೆ ಹೋಗಲು ಇಷ್ಟಪಡುತ್ತಿದೆ.
It looks like we got lucky.	ನಮಗೆ ಅದೃಷ್ಟ ಸಿಕ್ಕಿತು ಅಂತ ಅನಿಸುತ್ತೆ.
That's why he lost his job.	ಅದಕ್ಕೇನೇ ಅವನು ಅವನ ಕೆಲಸ ಕಳೆದುಕೊಂಡ.
This is a horrible tragedy.	ಇದು ಭಯಾನಕವಾದ ದುರಂತ.
We'll think of another way.	ಬೇರೆ ರೀತಿಯಲ್ಲಿ ಯೋಚನೆ ಮಾಡೋಣ.
What do you think about it?	ನಿಮಗೆ ಏನು ಅನ್ನಿಸುತ್ತೆ
I really owe you an apology.	ನಿಜವಾಗಿಯೂ ನಾನು ನಿಮಗೆ ಕ್ಷಮೆ ಕೋರಬೇಕು.
I suggest we don't even try.	ನಾವು ಪ್ರಯತ್ನಿಸದೇ ಬೇಡ ಅಂತ ಸೂಚಿಸುತ್ತೇನೆ.
Open your book on page nine.	ನಿಮ್ಮ ಪುಸ್ತಕವನ್ನು ಒಂಬತ್ತನೆಯ ಪುಟಕ್ಕೆ ತೆರೆಯಿರಿ.
She brought up two children.	ಅವಳು ಎರಡು ಮಕ್ಕಳನ್ನು ಸಾಕಿದಳು.
Tom knew who the killer was.	ಟಾಮಿಗೆ ಯಾರು ಕೊಲೆಗಾರ ಅಂತ ಗೊತ್ತಿತ್ತು.
Where can we find the truth?	ನಾವು ಸತ್ಯವನ್ನು ಎಲ್ಲಿ ಕಂಡುಹಿಡಿಯಬಹುದು?
Have you ever eaten raw fish?	ನೀವು ಯಾವಾಗಲಾದರೂ ಕಚ್ಚಾ ಮೀನು ತಿಂದಿದ್ದೀರಾ?
I'm getting better every day.	ಪ್ರತಿದಿನ ನಾನು ಸುಧಾರಿಸುತ್ತಿದ್ದೇನೆ.
Let's get it right this time.	ಈ ಸಲ ನಾವು ಸರಿಯಾಗಿ ಮಾಡೋಣ.
She got married in her teens.	ಅವಳು ಹದಿವಯಸ್ಸಿನಲ್ಲಿ ಮದುವೆಯಾಗಿದಳು.
That's not really a solution.	ಅದು ಪರಿಹಾರ ಇಲ್ಲವೇ ಇಲ್ಲ.
Does Tom have a crush on Mary?	ಟಾಮ್ ಮೇರಿ ಮೇಲೆ ಪ್ರೀತಿ ಇದ್ಯಾ?
I can recommend a good lawyer.	ನಾನು ನಿಮಗೆ ಒಳ್ಳೆಯ ವಕೀಲರನ್ನು ಸೊಚಿಸಬಹುದು.
I'd like to see the agreement.	ಒಪ್ಪ೦ದವನ್ನು ನೋಡುವುದಕ್ಕೆ ನಾನು ಇಷ್ಟಪಡುತ್ತೇನೆ.
She has something in her hand.	ಅವಳು ಅವಳ ಕೈಯಲ್ಲಿ ಏನೋ ಇಟ್ಟುಕೊಂಡಿದ್ದಾಳೆ.
There's nothing in the bucket.	ಬಾದಲಿಯಲ್ಲಿ ಏನೂ ಇಲ್ಲ.
This room looks like a pigsty.	ಈ ಕೊಠಡಿ ಹಂದಿಮನೆ ತರಹ ಇದೆ.
We should call off the search.	ನಾವು ಹುಡುಕಾಟವನ್ನು ರದ್ಧುಗೊಳಿಸಬೇಕು.
Do you need something to drink?	ಕುಡಿಯೋಕ್ಕೆ ಏನಾದ್ರು ಬೇಕಾ ?
Give my regards to your family.	ನಿಮ್ಮ ಕುಟುಂಬಕ್ಕೆ ನನ್ನ ಪರವಾಗಿ ಶುಭಾಕಾಂಕ್ಷೆಗಳನ್ನು ನೀಡಿ.
I don't know what came over me.	ನನಗೆ ಏನಾಯಿತು ಅಂತ ನನಗೇನೆ ಗೊತ್ತಿಲ್ಲ.
Do you think it means something?	ಅದಕ್ಕೆ ಅರ್ಥ ಇದೆ ಎಂದು ನಿಮಗೆ ಅನಿಸುತ್ತಾ?
I'm glad you guys could make it.	ನೀವೆಲ್ಲ ಬಂದಿದ್ದು ನನಗೆ ತುಂಬಾ ಸಂತೋಷ.
I'm sorry I missed your concert.	ಕ್ಷಮಿಸಿ ನಿಮ್ಮ ಕಛೇರಿಗೆ ಬರುವದಕ್ಕೆ ಆಗಲಿಲ್ಲ.
Some animals are afraid of fire.	ಕೆಲವೊಂದು ಪ್ರಾಣಿಗಳು ಬೆಂಕಿಗೆ ಹೆದರುತ್ತವೆ.
Tell us what you know about Tom.	ಟಾಮ್ ಬಗ್ಗೆ ಏನೆಲ್ಲಾ ಗೊತ್ತೋ ನಮಗೆ ಹೇಳಿ.
Tom stared sadly out the window.	ಟಾಮ್ ಕಿಟಕಿಯ ಹೊರಗೆ ದುಃಖದಿಂದ ನೋಡುತ್ತಲಿರುತ್ತಿದ್ದನು.
Can you suggest another solution?	ಇನ್ನೊಂದು ಪರಿಹಾರವನ್ನು ಸುಚಿಸುತ್ತೀರಾ?
Don't forget to put out the fire.	ಬೆಂಕಿಯನ್ನು ನಂದಿಸುವುದಕ್ಕೆ ಮರೆಯಬೇಡಿ.
Don't forget to put the fire out.	ಬೆಂಕಿಯನ್ನು ನಂದಿಸುವುದಕ್ಕೆ ಮರೆಯಬೇಡಿ.
I have enough money to buy a car.	ನನಗೆ ಕಾರನ್ನು ಖರೀದಿಸುವುದಕ್ಕೆ ಸಾಕಷ್ಟು ಹಣವಿದೆ.
I wondered the same thing myself.	ಅದೇ ಪ್ರಶ್ನೆ ನನ್ನನ್ನೇ ಕೇಳಿದೆ.
Do you want to leave it like that?	ನಿಮಗೆ ಅದನ್ನು ಹಂಗೇ ಬಿಡಬೇಕಾ?
He arrived at the station at five.	ಅವನು ಠಾಣೆಗೆ ಐದು ಗಂಟೆಗೆ ತಲುಪಿದ.
I thought the food was too greasy.	ಆಹಾರಕ್ಕೆ ತುಂಬಾ ಎಣ್ಣೆ ಇತ್ತು ಅಂತ ಅನಿಸಿತು.
It's my fault that you were fired.	ನಿನ್ನನ್ನು ಕೆಲಸದಿಂದ ತೆಗೆದಿರುವುದಕ್ಕೆ ನಾನೇ ಕರಣ ಮತ್ತು ನಂದೇ ತಪ್ಪು.
Put it back where you got it from.	ಇದನ್ನು ಎಲ್ಲಿ ಸಿಕ್ಕಿತ್ತೋ ಅಲ್ಲೇ ಇಡು.
She treats me as if I were a baby.	ನನ್ನನ್ನು ಎಳೆಮಗು ತರಹ ಪರಿಗಣಿಸುತ್ತಾಳೆ.
The accident caused a traffic jam.	ಅಪಘಾತದ ಕಾರಣದಿಂದ ಸಂಚಾರ ಸ್ತಂಭನ ಇತ್ತು.
These are Tom's glasses, not mine.	ಇದು ಟಾಮಿನ ಕನ್ನಡಕ, ನನ್ನದಿಲ್ಲ.
To be honest, I really don't know.	ಪ್ರಾಮಾಣಿಕವಾಗಿ ಹೇಳಬೇಕೆಂದರೆ, ನಾನು ಗೊತ್ತಿಲ್ಲ
Tom won't be killing anybody else.	ಟಾಮ್ ಬೇರೆಯಾರನ್ನೂ ಕೊಲ್ಲಲ್ಲ.
Would you mind my moving your car?	ನಿಮಗೆ ತೊಂದರೆ ಇಲ್ಲವೆಂದರೆ ನಿಮ್ಮ ಕಾರನ್ನು ಜರಗಿಸುತ್ತೀರಾ?
Are you finished reading the paper?	ನೀವು ಪತ್ರಿಕೆಯನ್ನು ಓದಿ ಮುಗಿಸಿದ್ದೀರಾ?
He bought his daughter a new dress.	ಅವನು ಅವನ ಮಗಳಿಗೆ ಹೊಸ ಬಟ್ಟೆಯನ್ನು ಖರೀದಿಸಿದನು.
Isn't that what we should be doing?	ಅದೇ ನಾವು ಮಾಡ್ಬೇಕು ಅಲ್ಲವ?
They've announced their engagement.	ಅವರು ಅವರ ನಿಶ್ಚಿತಾರ್ಥದವನ್ನು ಪ್ರಕಟಿಸಿದ್ದಾರೆ.
You can't be in two places at once.	ನಿಮಗೆ ಒಂದೇ ಬಾರಿ ಎರಡು ಜಾಗದಲ್ಲಿ ಇರುವುದಕ್ಕೆ ಆಗಲ್ಲ.
Are you sure we've never met before?	ನಾವು ಮುಂಚೆ ಎಂದಿಗೂ ಭೇಟಿಯಾಗಿಲ್ಲವೆಂದು ಖಚಿತವಾಗಿ ಹೇಳುತ್ತೀರಾ?
Do you know what Tom's last name is?	ಟಮಿನ ಉಪನಾಮ ಏನು ಅಂತ ನಿಮಗೆ ಗೊತ್ತ?
I didn't know that Tom spoke French.	ನನಗೆ ಟಾಮ್ ಫ್ರೆಂಚ್ ಮಾತಾಡುತ್ತಾನೆ ಅಂತ ಗೊತ್ತೇ ಇರಲಿಲ್ಲ.
I just want to say that I was wrong.	ನಾನು ತಪ್ಪು ಮಾಡಿದೆ ಎಂದು ಹೇಳಬೇಕು.
I no longer feel that way about you.	ನಾನು ನಿನನ್ನು ಇನ್ನು ಮುಂದೆ ಅದೇ ರೀತಿಯಲ್ಲಿ ಭಾವಿಸುವುದಿಲ್ಲ.
Let's hope we never have to do that.	ಅದನ್ನು ಎಂದಿಗೂ ಮಾಡಬೇಡವೆಂದು ನಂಬೋಣ.
The couple posed for the photograph.	ಜೋಡಿ ಇಬ್ಬರು ಫೋಟೋಗೆ ನಿಲ್ಲಿದರು.
What could possibly have gone wrong?	ತಪ್ಪು ಆಗುವುದಕ್ಕೆ ಹೇಗೆ ಸಾಧ್ಯ?
When does Tom usually go to the gym?	ಟಾಮ್ ಸಾಮಾನ್ಯವಾಗಿ ಯಾವಾಗ ಜಿಮ್ಮಿಗೆ ಹೋಗುತ್ತಾನೆ?
I can tell this is difficult for you.	ಇದು ನಿಮಗೆ ಕಷ್ಟವಿದೆ ಎಂದು ನನಗೆ ತಿಳಿದು ಬರುತ್ತದೆ.
I made sure that no one was watching.	ಯಾರೂ ನೋಡುತ್ತಿರಲಿಲ್ಲವೆಂದು ನಾನು ಖಚಿತಪಡಿಸಿಕೊಂಡೆ.
It cost twice as much as we expected.	ನಾವು ಎಷ್ಟು ನಿರೀಕ್ಷಿಸುತ್ತಾ ಇದ್ದವೋ ಅದಕ್ಕಿಂತ ಎರಡರಷ್ಟು ಬೆಲೆ ಆಯಿತು.
She tried to get whatever she wanted.	ಏನೆಲ್ಲಾ ಅವಳಿಗೆ ಬೇಕಿತ್ತೋ ಅದನ್ನು ಖರೀದಿಸುವುದಕ್ಕೆ ಪ್ರಯತ್ನಿಸಿದಳು.
She will be relocated to New Zealand.	ಅವಳನ್ನು ನ್ಯೂ ಜಿಲಂಡಿಗೆ ಸ್ಥಳಾಂತರಿಸುತ್ತಾರೆ.
The cause of the accident is unknown.	ಅಪಘಾತದ ಕಾರಣವೇ ಗೊತ್ತಿಲ್ಲ.
The story got more and more exciting.	ಆ ಕಥೆ ಇನ್ನಷ್ಟು ಹೆಚ್ಚು ಅದ್ಭುತವಾಯಿತು.
I don't know how I can ever thank you.	ನಿಮಗೆ ಹೇಗೆ ಧನ್ಯವಾದ ಹೇಳಕ್ಕೆ ಗೊತ್ತಾಗುತ್ತಾ ಇಲ್ಲ.
Maybe Tom doesn't tell you everything.	ಬಹುಷಃ ಟಾಮ್ ನಿನಗೆ ಎಲ್ಲದರ ಬಗ್ಗೆ ಹೇಳಲ್ಲ.
She was very bored during the lecture.	ಪ್ರವಚನ ನಡೆಯುತ್ತಿರುವಾಗ ನನಗೆ ತುಂಬಾ ಬೇಸರವಾಗಿತ್ತು.
They failed to fulfill the conditions.	ಅವರು ನಿಯಮಗಳನ್ನು ನೇರವೇರಿಸುವುದಕ್ಕೆ ಆಗಲಿಲ್ಲ.
You don't think I can do this, do you?	ನೀನು ಇದನ್ನು ಮಾಡಕ್ಕೆ ಆಗುವುದಿಲ್ಲವೆಂದು ನಂಬಿದ್ದೀಯಾ ಅಲ್ವ?
He couldn't keep his temper any longer.	ಜಾಸ್ತಿ ಹೊತ್ತು ಅವನಿಗೆ ಅವನ ಕೋಪ ತಡೆಯುವುದಕ್ಕೆ ಆಗಲಿಲ್ಲ.
Tom promised to help me, but he didn't.	ಟಾಮ್ ಸಹಾಯ ನೀಡುತ್ತಾನೆಂದು ನನಗೆ ಭರವಸೆ ಕೊಟ್ಟನು ಆದರೆ ಕೊಡಲಿಲ್ಲ.
It very likely is going to be dangerous.	ಅಪಾಯ ಇರುವುದಕ್ಕೆ ಬಹಳ ಸಾಧ್ಯತೆ ಇದೆ.
Brazil declared war on Argentina in 1825.	ಬ್ರಸಿಲು ಅರ್ಜೆಂಟೀನದ ಮೇಲೆ ಯುದ್ಧವನ್ನು ಪ್ರಕಟಿಸಿದರು.
A great deal has happened since that time.	ಅಂದಿನಿಂದ ಬಹಳಷ್ಟು ಘಟನೆಗಳು ನಡೆದಿವೆ.
Where can dollars be exchanged for pounds?	ಎಲ್ಲಿ ಡಾಲರ್ಗಳನ್ನು ಪೌಂಡ್ಸ್ಗೆ ಬದಲಾಯಿಸಬಹುದು?
A few firefighters suffered minor injuries.	ಕೆಲವೊಂದು ಅಗ್ನಿಶಾಮಕರು ಗಾಯ ಪಟ್ಟರು.
I should've gotten up earlier this morning.	ನಾನು ಇವತ್ತು ಬೆಳಿಗ್ಗೆ ಬೇಗ ಏಳಬೇಕಾಗಿತ್ತು.
My father and my brother work in this factory.	ನನ್ನ ತಂದೆ ಹಾಗು ನನ್ನ ಅಣ್ಣ ಈ ಕಾರ್ಖಾನೆಯಲ್ಲಿ ಕೆಲಸ ಮಾಡುತ್ತಾರೆ.
You have to tell me exactly what I need to do.	ನಾನು ಏನನ್ನು ಮಾಡಬೇಕೆಂದು ಸರಿಯಾಗಿ ನೀವು ಹೇಳಬೇಕು.
I'll let you know if I find anything interesting.	ಏನೋ ಆಕರ್ಷಕವಾಗಿದ್ದರೆ ನಾನು ನಿನಗೆ ತಿಳಿಸುತ್ತೇನೆ.
There are many new programs to watch this spring.	ಬರುವ ವಸಂತಕಾಲದಲ್ಲಿ ನೋಡುವುದಕ್ಕೆ ಹಲವರು ಕಾರ್ಯಕ್ರಮಗಳು ಇವೆ.
He took charge of the firm after his father's death.	ಅವನ ತಂದೆಯ ಮರಣಾನಂತರ ಅವನು ಸಂಸ್ಥೆಯ ಅಧಿಕಾರ ವಹಿಸಿಕೊಂಡಿದನು.
His trip will keep him away from the office for a week.	ಅವನ ಪಯಣ ಅವನನ್ನು ಆಫೀಸಿನಿಂದ ದೂರ ಇಡತ್ತೆ.
They caught sight of the man among the crowd of people.	ಅವರು ಜನಸಮೊಹದ ನಡುವೆ ಅವನನ್ನು ಕಂಡಿದರು.
In order to stay awake, I may have to drink more coffee.	ಎಚ್ಚರವಾಗಿರಲು ನಾನು ಇನ್ನು ಸ್ವಲ್ಪ ಕಾಫಿ ಕುಡಿಯಬೇಕು ಅಂತ ಅನಿಸುತ್ತೆ.
The only time you talk to me is when you need some money.	ಯಾವಾಗ ನಿನಗೆ ದುಡ್ಡು ಬೇಕಾದರೆ ಮಾತ್ರ ನೀನು ನನ್ನ ಜೊತೆ ಮಾತನಾಡುತ್ತೇಯ.
Go to the wine cellar and get a couple of bottles of wine.	ಸರಾಯಿ ನೆಲಮಾಳಿಗೆಗೆ ಹೋಗಿ ಎರಡು ಬಾಟಲಿ ವೈನು ತೆಗೆದುಕೊಂಡು ಬನ್ನಿ.
It was because he was sick that he decided to return home.	ಅವನಿಗೆ ಹುಷಾರು ಇರಲಿಲ್ಲ ಅಂತ ಅವನು ಮನಗೆ ವಾಪಸ್ಸು ಬರವುದಕ್ಕೆ ನಿರ್ದರಿಸಿದ.
Both my father and I went to the museum for the first time.	ನಾನು ಮತ್ತು ನನ್ನ ತಂದೆ ಮೊದಲ ಬಾರಿಗೆ ಸಂಗ್ರಾಲಯಕ್ಕೆ ಹೋದ್ವಿ.
You would've gotten away with it if Tom hadn't told on you.	ಒಂದು ವೇಳೆ ಟಾಮ್ ನಿನ್ನ ಬಗ್ಗೆ ಹೇಳಲಿಲ್ಲವೆಂದರೆ ತಪ್ಪಿಸಿಕೊಳ್ಳಬಹುದಾಗಿತ್ತು.
Any time you want to borrow my car, all you have to do is ask.	ಯಾವಾಗಲಾದರು ನೀವು ನನ್ನ ಕಾರನ್ನು ಬೇಕೆಂದರೆ, ಬರಿ ಕೇಳಿ.
I forgot Tom was the one who taught you how to play the guitar.	ಟಾಮ್ ನಿಮಗೆ ಗಿಟಾರ್ ಭಾರಿಸುವುದಕ್ಕೆ ಹೇಳಿಕೊಟ್ಟನೆಂದು ನನಗೆ ಮರೆತುಹೋಯಿತು.
