Go on.	Tęsk.
Go on.	Tęskite.
Hurry!	Paskubėk!
Hurry!	Greičiau!
I try.	Aš bandau.
Smile.	Šypsokis.
He ran.	Jis bėgo.
I know.	Aš žinau.
Listen.	Klausyk.
Why me?	Kodėl aš?
Get out.	Išeik.
He came.	Jis atėjo.
He runs.	Jis bėga.
Help me!	Padėk man!
Help me!	Padėkite man!
I agree.	Aš sutinku.
I'm hot.	Man karšta.
Open up.	Atsiverk.
Perfect!	Tobula!
Wash up.	Nusiprausk.
Why not?	Kodėl ne?
You run.	Tu bėgi.
You run.	Jūs bėgate.
Have fun.	Pasilinksmink.
How cute!	Kaip miela!
How deep?	Kaip giliai?
Hurry up.	Paskubėk.
I resign.	Aš pasiduodu.
Too late.	Per vėlai.
Trust me.	Pasitikėk manimi.
We agree.	Mes sutinkame.
Write me.	Rašyk man.
Write me.	Parašyk man.
After you.	Po tavęs.
Answer me.	Atsakyk man.
Answer me.	Atsakykite man.
Catch him.	Pagauk jį.
Come home.	Grįžk namo.
Forget it.	Pamiršk tai.
I fainted.	Aš apalpau.
Pardon me?	Prašau?
Pardon me?	Atsiprašau?
Seriously?	Rimtai?
She walks.	Ji vaikšto.
She walks.	Ji eina.
Stay home.	Likite namie.
Stop that!	Nustok tai!
Stop them.	Sustabdykite juos.
Take care.	Laikykis.
Try again.	Bandyk dar kartą.
Try again.	Bandykite dar kartą.
You stink.	Jūs dvokiate.
You stink.	Tu dvoki.
You tried.	Tu bandei.
Choose one.	Pasirink vieną.
Follow him.	Sek jį.
Follow him.	Sekite jį.
He made it.	Jam tai pavyko.
He made it.	Jis tai padarė.
Hey, relax.	Ei, ramiau.
Hey, relax.	Ei, ramiai.
Hurry back.	Paskubėk grįžti.
I am ready.	Aš pasiruošęs.
I am ready.	Aš pasiruošusi.
I can read.	Aš moku skaityti.
I can read.	Aš galiu skaityti.
I was busy.	Aš buvau užimta.
I was busy.	Aš buvau užimtas.
I'm a hero.	Aš esu didvyris.
Never mind!	Nieko tokio!
No problem.	Be problemų.
Stay there.	Lik čia.
Step aside.	Pasitrauk.
Step aside.	Pasitrauk į šalį.
Tom drives.	Tomas vairuoja.
Turn right.	Pasuk į dešinę.
Wood burns.	Mediena dega.
Be creative.	Būk kūrybingas.
Be creative.	Būk kūrybinga.
Be creative.	Būkite kūrybinga.
Be creative.	Būkite kūrybingas.
Be creative.	Būkite kūrybingi.
Be friendly.	Būk draugiškas.
Be friendly.	Būk draugiška.
Be friendly.	Būkite draugiškas.
Be friendly.	Būkite draugiška.
Be friendly.	Būkite draugiški.
Count on me.	Pasikliauk manimi.
Count on me.	Pasikliaukite manimi.
Have a beer.	Išgerk alaus.
Have a beer.	Atsigerk alaus.
Have a look.	Pasižiūrėk.
He is lying.	Jis meluoja.
Hear me out.	Išklausyk mane.
Hear me out.	Išklausykite mane.
How strange!	Kaip keista!
I love cats.	Aš mėgstu kates.
I loved you.	Aš mylėjau tave.
I'm a loser.	Aš nevykėlis.
I'm a loser.	Aš nevykėlė.
I'm retired.	Esu pensijoje.
I'm useless.	Esu niekam tikęs.
I'm useless.	Esu niekam tikusi.
Money talks.	Pinigai šneka.
Nobody came.	Niekas neatėjo.
OK. I agree.	Gerai. Sutinku.
Please come.	Prašau ateiti.
That is all.	Tai viskas.
They may go.	Jie gali eiti.
Tom blushed.	Tomas paraudo.
Tom frowned.	Tomas susiraukė.
Tom's bored.	Tomas nuobodžiauja.
Turn around.	Apsisuk.
Walk slowly.	Eik lėtai.
We all work.	Mes visi dirbame.
We're ready.	Mes pasirengę.
We're ready.	Mes pasirengusios.
Work slowly.	Dirbk lėtai.
You're lazy.	Tu esi tingus.
You're lazy.	Tu esi tingi.
Anything new?	Kas nors naujo?
Beef, please.	Jautienos, prašau.
Can I finish?	Ar galiu pabaigti?
Come quickly.	Ateik greitai.
Don't be shy.	Nesidrovėk.
Ghosts exist.	Vaiduokliai egzistuoja.
He loved her.	Jis ją mylėjo.
He was brave.	Jis buvo drąsus.
I don't care.	Man nerūpi.
I hate liars.	Aš nekenčiu melagių.
I like women.	Aš mėgstu moteris.
I like women.	Man patinka moterys.
I want a dog.	Aš noriu šuns.
I'll be back.	Aš sugrįšiu.
I'm a lawyer.	Aš esu advokatas.
Is it for me?	Ar tai man?
Is this love?	Ar tai yra meilė?
Jump over it.	Peršok jį.
Ladies first.	Damoms - pirmenybė.
Life goes on.	Gyvenimas tęsiasi.
Move quietly.	Judėk tyliai.
My arm hurts.	Man skauda ranką.
Nobody knows.	Niekas to nežino.
Nobody knows.	Niekas nežino.
Please hurry.	Prašau paskubėti.
Please leave.	Prašau išeiti.
Someone came.	Kažkas atėjo.
Stay at home.	Likite namie.
Stop gawking.	Nustok vėpsoti.
Stop smoking.	Nustok rūkyti.
Sweet dreams!	Saldžių sapnų!
Tom chuckled.	Tomas sukrizeno.
We apologize.	Atsiprašome.
We have time.	Mes turime laiko.
We're strict.	Mes esame griežti.
Where are we?	Kur mes?
Where are we?	Kur mes esame?
You can rest.	Gali pailsėti.
You're wrong.	Tu klysti.
Anything else?	Dar ko nors?
Anything else?	Dar kas nors?
Everyone dies.	Visi miršta.
Flowers bloom.	Gėlės žydi.
Give me a hug.	Apkabink mane.
I almost died.	Aš buvau beveik miręs.
I almost died.	Aš vos nemiriau.
I cried a lot.	Aš daug verkiau.
I got the flu.	Aš susirgau gripu.
I hate winter.	Nekenčiu žiemos.
I have a ring.	Aš turiu žiedą.
I have doubts.	Aš turiu abejonių.
I must refuse.	Aš privalau atsisakyti.
I need a room.	Man reikia kambario.
I'm no expert.	Nesu ekspertas.
I'm not blind.	Aš nesu aklas.
I'm not blind.	Aš ne akla.
It's terrible.	Tai siaubinga.
She hired him.	Ji pasamdė jį.
She was brave.	Ji buvo drąsi.
She's my wife.	Ji yra mano žmona.
Speak clearly.	Kalbėk aiškiai.
Start writing.	Pradėkite rašyti.
Start writing.	Pradėk rašyti.
Take my horse.	Paimk mano arklį.
That's my dog.	Tai mano šuo.
The girls won.	Mergaitės laimėjo.
They're armed.	Jie ginkluoti.
This is a dog.	Tai šuo.
Tom is OK now.	Dabar Tomui viskas gerai.
Tom is unsure.	Tomas nėra tikras.
Tom likes you.	Tu patinki Tomui.
Tom likes you.	Jūs patinkate Tomui.
Tom looks ill.	Tomas atrodo ligotas.
Tom was harsh.	Tomas buvo grubus.
Tom was quiet.	Tomas buvo tylus.
Tom was tough.	Tomas buvo kietas.
Tom, I'm back.	Tomai, aš grįžau.
Tom, I'm home.	Tomai, aš namie.
We are at war.	Mes esame kare.
We can't wait.	Mes negalime laukti.
What about me?	O kaip dėl manęs?
What happened?	Kas atsitiko?
What happened?	Kas nutiko?
Who's calling?	Kas skambina?
You came back.	Tu sugrįžai.
You came back.	Jūs sugrįžote.
You know that.	Tu žinai tai.
You look ugly.	Tu atrodai negražus.
You look ugly.	Tu atrodai negraži.
You're a wimp.	Tu esi ištižėlis.
Are they alive?	Jie gyvi?
Aren't you Tom?	Ar tu ne Tomas?
Be careful, OK?	Būk atsargus, gerai?
Be careful, OK?	Būkite atsargūs, gerai?
Be careful, OK?	Būk atsargi, gerai?
Be careful, OK?	Būkite atsargus, gerai?
Be careful, OK?	Būkite atsargi, gerai?
Can't you read?	Ar tu negali skaityti?
Can't you read?	Ar jūs negalite skaityti?
Close the book.	Užversk knygą.
Dancing is fun.	Šokti yra smagu.
Do as you want.	Daryk, kaip nori.
Don't help Tom.	Nepadėk Tomui.
Don't help Tom.	Nepadėkite Tomui.
Everybody knew.	Visi žinojo.
Everybody lies.	Visi meluoja.
Happy birthday!	Laimingo gimtadienio!
I am a teacher.	Aš esu mokytojas.
I hate carrots.	Nekenčiu morkų.
I have a house.	Aš turiu namą.
I have no food.	Aš neturiu maisto.
I love bananas.	Aš mėgstu bananus.
I was sleeping.	Aš miegojau.
I'm busy today.	Šiandien esu užsiėmęs.
I'm busy today.	Šiandien esu užsiėmusi.
I'm not a liar.	Aš ne melagis.
I'm not a liar.	Aš ne melagė.
I'm not crying.	Aš neverkiu.
It's a snowman.	Tai sniego senis.
It's a snowman.	Tai senis besmegenis.
It's very good.	Tai labai gerai.
Keep listening.	Klausykis ir toliau.
Louder, please.	Garsiau, prašau.
Mary likes you.	Merė tave myli.
My wife is mad.	Mano žmona išprotėjo.
She loves cats.	Ji myli kates.
Smoke appeared.	Atsirado dūmai.
Stop grumbling.	Baik niurnėti.
They need help.	Jiems reikia pagalbos.
They quarreled.	Jie ginčijosi.
This is fennel.	Tai pankolis.
This was a lie.	Tai buvo melas.
Tom had to run.	Tomui teko bėgti.
Tom is married.	Tomas yra vedęs.
Tom looks sick.	Tomas atrodo ligotas.
Tom walks fast.	Tomas vaikšto greitai.
Tom was biased.	Tomas buvo šališkas.
Tom was boring.	Tomas buvo nuobodus.
We're all here.	Mes visi čia esame.
We've got time.	Mes turime laiko.
Who wrote this?	Kas tai parašė?
You were brave.	Tu buvai drąsus.
You were right.	Jūs buvote teisūs.
You were right.	Tu buvai teisus.
You're kidding!	Tu juokauji!
Are these yours?	Ar tai tavo?
Can you show me?	Ar gali man parodyti?
Can you show me?	Ar galite man parodyti?
Come on in, Tom.	Užeik, Tomai.
Did Tom do that?	Ar tai Tomas padarė?
Do you know him?	Ar jūs jį pažįstate?
Do you know him?	Ar tu jį pažįsti?
Don't forget it.	Nepamiršk to!
Don't forget it.	Neužmiršk to!
Eat more slowly.	Valgyk lėčiau.
Eat more slowly.	Valgykite lėčiau.
Everyone dreams.	Visi svajoja.
Facts are facts.	Faktai yra faktai.
Grab your stuff.	Griebk savo daiktus.
He lost his job.	Jis neteko darbo.
Hi! How are you?	Labas! Kaip sekasi?
I abhor spiders.	Aš negaliu pakęsti vorų.
I can do better.	Aš galiu padaryti geriau.
I can't be sure.	Negaliu būti tikras.
I can't be sure.	Negaliu būti tikra.
I hate this job.	Nekenčiu šito darbo.
I have two sons.	Turiu du sūnus.
I know her well.	Aš gerai ją pažįstu.
I talked to Tom.	Aš kalbėjausi su Tomu.
I was a witness.	Aš buvau liudytoja.
I was a witness.	Aš buvau liudytojas.
I was too small.	Buvau per mažas.
I'll assist you.	Aš padėsiu tau.
I'll assist you.	Aš padėsiu jums.
I'll go by taxi.	Aš važiuosiu su taksi.
I'm a Christian.	Aš esu krikščionis.
I'm a bit drunk.	Aš truputį išgėręs.
I'm almost sure.	Esu beveik įsitikinusi.
I'm almost sure.	Esu beveik įsitikinęs.
I'm almost sure.	Esu beveik tikra.
I'm almost sure.	Esu beveik tikras.
It's time to go.	Metas eiti.
Mary's my niece.	Merė - mano dukterėčia.
Please continue.	Prašau tęsti.
Sharks eat fish.	Rykliai ėda žuvis.
They are pilots.	Jie pilotai.
They don't help.	Jie nepadeda.
They might come.	Jie gali ateti.
This isn't easy.	Tai nelengva.
Tom drinks milk.	Tomas geria pieną.
Tom is a Cancer.	Tomas yra Vėžys.
Tom isn't weird.	Tomas nėra keistas.
Tom loves books.	Tomas dievina knygas.
We're not wrong.	Mes nesame neteisūs.
We're teenagers.	Mes esame paaugliai.
What do you see?	Ką tu matai?
What do you see?	Ką jūs matote?
Where's my wife?	Kur mano žmona?
You betrayed me.	Tu išdavei mane.
You have to try.	Tu turi pabandyti.
A lion is strong.	Liūtas yra stiprus.
Do you like snow?	Ar tau patinka sniegas?
Don't forget Tom.	Nepamiršk Tomo.
Don't forget Tom.	Nepamirškite Tomo.
How about a bite?	Gal kąsnelį?
I am a bit drunk.	Aš truputį išgėręs.
I can't remember.	Aš negaliu prisiminti.
I don't need you.	Tu man nereikalingas.
I don't remember.	Aš neprisimenu.
I feel depressed.	Jaučiuosi prislėgta.
I feel depressed.	Jaučiuosi prislėgtas.
I hate computers.	Nekenčiu kompiuterių.
I have blue eyes.	Aš turiu mėlynas akis.
I have blue eyes.	Mano akys mėlynos.
I like ice cream.	Aš mėgstu ledus.
I love this band.	Dievinu šią grupę.
I saw everything.	Aš viską mačiau.
I was very tired.	Buvau labai pavargęs.
I was very tired.	Buvau labai pavargusi.
I won't stop you.	Aš nelaikysiu tavęs.
I work in a bank.	Aš dirbu banke.
I'll ignore that.	Aš nekreipsiu į tai dėmesio.
I'll ignore that.	Aš ignoruosiu tai.
I'll lose weight.	Aš sulieknėsiu.
I'm already busy.	Aš jau užsiėmęs.
I'm already busy.	Aš jau užsiėmusi.
I'm always tired.	Aš visada pavargęs.
I'm always tired.	Aš visada pavargusi.
I'm baking bread.	Aš kepu duoną.
I'm feeling down.	Aš jaučiuosi prislėgta.
I'm feeling down.	Aš jaučiuosi prislėgtas.
I'm going inside.	Aš einu į vidų.
Listen carefully.	Klausykis atidžiai.
My stomach hurts.	Man skauda pilvą.
Nothing happened.	Nieko neįvyko.
Please don't cry.	Prašau, neverk.
Someone is lying.	Kažkas meluoja.
The battery died.	Baterija numirė.
The cat is black.	Katė yra juoda.
The dog is dying.	Šuo miršta.
The meat spoiled.	Mėsa pagedo.
There is one way.	Yra vienas kelias.
There's a mirror.	Tenai yra veidrodis.
This is my phone.	Tai mano telefonas.
Tom is an intern.	Tomas yra praktikantas.
Tom is an orphan.	Tomas yra našlaitis.
Tom is excellent.	Tomas yra puikus.
Tom is talkative.	Tomas kalbus.
Tom is very rich.	Tomas labai turtingas.
Tom is your heir.	Tomas yra tavo įpėdinis.
Tom needed money.	Tomui reikėjo pinigų.
What did she say?	Ką ji pasakė?
What did we miss?	Ką mes praleidome?
What is he after?	Ko jis siekia?
What is he after?	Ko jam reikia?
Where is the cat?	Kur yra katė?
Where's a mirror?	Kur veidrodis?
Where's your bag?	Kur tavo krepšys?
Who brought this?	Kas tai atnešė?
Who's the father?	Kas tėvas?
Why did you call?	Kodėl skambinai?
You're ambitious.	Tu esi ambicingas.
You're too naive.	Tu per daug naivus.
You're too naive.	Tu per daug naivi.
Are they Japanese?	Ar jie japonai?
Champagne, please.	Prašau šampano.
Cows give us milk.	Karvės mums duoda pieną.
Did you know that?	Ar tu tai žinojai?
Did you like that?	Ar tau tai patiko?
Do you play chess?	Ar jūs žaidžiate šachmatais?
Do you play chess?	Ar tu žaidi šachmatais?
Do you want a job?	Ar jūs norite darbo?
Dogs are faithful.	Šunis yra ištikimi.
Don't be too sure.	Nebūk per daug įsitikinęs.
Don't do it again.	Nedaryk to dar kartą!
Don't do it again.	Daugiau to nedaryk!
Everybody laughed.	Visi juokėsi.
Everyone screamed.	Visi rėkė.
Have you showered?	Ar nusiprausei po dušu?
He is a scientist.	Jis mokslininkas.
I agreed with Tom.	Aš sutikau su Tomu.
I came back early.	Aš anksti grįžau.
I deny everything.	Aš neigiu viską.
I forget his name.	Aš pamiršau jo vardą
I had a bad dream.	Sapnavau košmarą.
I hate the winter.	Nekenčiu žiemos.
I have black eyes.	Mano akys juodos.
I have black eyes.	Aš turiu juodas akis.
I have everything.	Aš turiu viską.
I killed them all.	Aš juos visus nužudžiau.
I put on an apron.	Užsidėjau prijuostę.
I put on an apron.	Užsirišau prijuostę.
I really like him.	Jis tikrai man patinka.
I saw him running.	Aš mačiau jį bėgantį.
I saw your father.	Aš mačiau tavo tėvą.
I was in the bath.	Aš buvau vonioje.
I won't deny that.	Aš to neneigsiu.
I'm already ready.	Aš jau pasiruošęs.
I'm already ready.	Aš jau pasiruošusi.
I'm busy as a bee.	Esu labai užimtas.
I'm not a teacher.	Aš nesu mokytojas.
I'm not that fast.	Aš nesu toks greitas.
It was impossible.	Tai buvo neįmanoma.
It's Monday today.	Šiandien pirmadienis.
May I go home now?	Ar aš galiu dabar eiti namo?
My glass is empty.	Mano stiklinė tuščia.
My glass is empty.	Mano taurė tuščia.
Please just leave.	Prašau, tiesiog išeik.
That girl is Mary.	Ta mergaitė yra Merė.
That movie stinks!	Tas filmas siaubingas!
The cat scared me.	Katė išgąsdino mane.
The clock is fast.	Laikrodis skuba.
The night is dark.	Naktis yra tamsi.
They betrayed you.	Jie išdavė tave.
They don't listen.	Jie neklauso.
They drank coffee.	Jie geria kavą.
They need friends.	Jiems reikia draugų.
Tom answered back.	Tomas atsakė.
Tom came too late.	Tomas atvyko per vėlai.
Tom creeps me out.	Tomas mane baugina.
Tom didn't appear.	Tomas nepasirodė.
Tom has dark skin.	Tomo odos spalva tamsi.
Tom is a Don Juan.	Tomas yra donžuanas.
Tom is a linguist.	Tomas yra lingvistas.
Tom is a linguist.	Tomas yra kalbininkas.
Tom is a magician.	Tomas yra magas.
Tom wasn't amused.	Tomas nebuvo patenkintas
Tom will be ready.	Tomas bus pasiruošęs.
Tom will die soon.	Tomas greitai mirs.
Weren't you tired?	Ar tu nebuvai pavargęs?
Weren't you tired?	Ar tu nebuvai pavargusi?
What's the reason?	Kokia priežastis?
What's the reason?	Kame priežastis?
Where did they go?	Kur jie nuėjo?
Where do you live?	Kur tu gyveni?
Who told you this?	Kas jums tai pasakė?
You talk too much.	Tu per daug kalbi.
Bring me the flute.	Atnešk man fleitą.
Bring me the flute.	Atneškite man fleitą.
Come here and help.	Ateik čia ir padėk.
Easy come, easy go.	Kas lengvai gaunama, lengvai ir prarandama.
Everyone likes her.	Ją visi mėgsta.
He speaks too fast.	Jis kalba per greitai.
He's a bit jealous.	Jis truputį pavydi.
He's short and fat.	Jis žemas ir storas.
Hey, don't do that!	Ei, nedaryk to!
His pace quickened.	Jo žingsniai pagreitėjo.
I am not a teacher.	Nesu mokytojas.
I can't allow that.	Aš negaliu to leisti.
I didn't apologize.	Aš neatsiprašiau.
I didn't have time.	Neturiu laiko.
I don't eat cheese.	Aš nevalgau sūrio.
I don't fear death.	Aš nebijau mirties.
I don't understand.	Nesupratau.
I hate my computer.	Nekenčiu savo kompiuterio.
I have to see this.	Aš privalau tai pamatyti.
I heard you crying.	Girdėjau tave verkiant.
I missed my flight.	Aš pavėlavau į savo skrydį.
I mowed Tom's lawn.	Aš pjoviau Tomo veją.
I need inspiration.	Man reikia įkvėpimo.
I saw an explosion.	Aš mačiau sprogimą.
I want to be alone!	Aš noriu būti vienas!
I want to be alone!	Aš noriu būti viena!
I was born in 1988.	Aš gimiau 1988 metais.
I was very careful.	Aš buvau labai atsargi.
I was very careful.	Aš buvau labai atsargus.
I wish you success.	Linkiu jums sėkmės.
Is this seat taken?	Ar ši vieta užimta?
It is Monday today.	Šiandien pirmadienis.
It is already dark.	Jau tamsu.
It is already dark.	Jau sutemo.
It's just not fair.	Tai tiesiog nesąžininga.
It's just not safe.	Tai tiesiog nesaugu.
Italy isn't Greece.	Italija - tai ne Graikija.
May I call you Tom?	Ar galiu tave vadinti Tomu?
No one was injured.	Niekas nebuvo sužeistas.
No one's been hurt.	Niekas nebuvo sužeistas.
Nobody was injured.	Niekas nebuvo sužeistas.
People are talking.	Žmonės kalbasi.
Romantic, isn't it?	Romantiška, ar ne?
She made me a star.	Ji iš manęs padarė žvaigždę.
The bread is fresh.	Duona šviežia.
The girl is lonely.	Mergaitė vieniša.
The moon is bright.	Mėnulis ryškus.
The price is right.	Teisinga kaina.
The table is clean.	Stalas yra švarus.
They need our help.	Jiems reikalinga mūsų pagalba.
Tom can't read yet.	Tomas dar nemoka skaityti.
Tom got up at 7:00.	Tomas atsikėlė septintą valandą.
Tom has a headache.	Tomui skauda galvą.
Tom is a communist.	Tomas - komunistas.
Tom isn't an idiot.	Tomas ne idiotas.
Tom looked puzzled.	Tomas atrodė sumišęs.
Tom stole my money.	Tomas pavogė mano pinigus.
Tom wants to learn.	Tomas nori mokytis.
Tom will need help.	Tomui reikės pagalbos.
We have everything.	Mes turime viską.
What a coincidence!	Koks sutapimas!
Where's the bakery?	Kur yra kepykla?
Where's the mirror?	Kur veidrodis?
You are very brave.	Tu labai drąsus.
You are very brave.	Tu labai drąsi.
You speak too much.	Tu per daug kalbi.
You're an optimist.	Tu esi optimistas.
Your bath is ready.	Tavo vonia yra paruošta.
Are there survivors?	Ar yra išgyvenusiųjų?
Can I do this later?	Ar galiu padaryti tai vėliau?
Cats rule the world.	Katės valdo pasaulį.
Did you read it all?	Ar tu ją visą perskaitei?
Don't make me laugh.	Neversk manęs juoktis.
Don't touch my bike.	Neliesk mano dviračio.
Enjoy your holidays.	Smagių atostogų!
Enjoy your holidays.	Smagių išeiginių!
Enjoy your vacation.	Gerų jums atostogų!
Give me two minutes.	Duok man dvi minutes.
He became a pianist.	Jis tapo pianistu.
He bought her a dog.	Jis nupirko jai šunį.
He lives in Cardiff.	Jis gyvena Kardife.
He's very skeptical.	Jis yra labai skeptiškas.
How can Tom do this?	Kaip Tomas gali tai padaryti?
How can we find Tom?	Kaip mums rasti Tomą?
I can't draw a bird.	Aš negaliu nupiešti paukščio.
I don't like school.	Nemėgstu mokyklos.
I forgot to ask him.	Aš pamiršau jo paklausti.
I gave Tom a chance.	Aš daviau Tomui šansą.
I have but one wish.	Aš turiu tik vieną norą.
I have enough money.	Aš turiu pakankamai pinigų.
I have many friends.	Aš turiu daug draugų.
I haven't eaten yet.	Dar nevalgiau.
I haven't forgotten.	Aš nepamiršau.
I heard her singing.	Aš girdėjau ją dainuojant.
I just want to talk.	Aš tik noriu pasikalbėti.
I retired last year.	Išėjau į pensiją praėjusiais metais.
I want a girlfriend.	Aš noriu merginos.
I want to marry her.	Aš noriu ją vesti.
I wanted you to win.	Norėjau, kad laimėtum.
I will be back soon.	Aš greitai grįšiu.
I will try it again.	Aš pabandysiu tai vėl.
I'm faster than you.	Aš greitesnis už tave.
I'm faster than you.	Aš greitesnė už tave.
I'm faster than you.	Aš greitesnis už jus.
I'm faster than you.	Aš greitesnė už jus.
I'm the new teacher.	Aš esu naujas mokytojas.
Is Tom going to die?	Ar Tomas mirs?
It snowed yesterday.	Vakar snigo.
It was getting dark.	Temo.
It's beautiful here.	Čia gražu.
Love is like oxygen.	Meilė - kaip deguonis.
Now I recognize you.	Dabar tave atpažįstu.
She baked me a cake.	Ji man iškepė pyragą.
She has faults, too.	Ji turi ir trūkumų.
She opened the door.	Ji atidarė duris.
She opened the door.	Ji atvėrė duris.
Something's missing.	Kažko trūksta.
Tell her to call me.	Pasakyk jai, kad paskambintų man.
That was unexpected.	Tai buvo netikėta.
The kids are asleep.	Vaikai miega.
The law was changed.	Įstatymas buvo pakeistas.
The list is endless.	Sąrašas yra begalinis.
There goes the bell.	Štai ir skambutis.
They can't hear you.	Jie negali jūsų girdėti.
They can't hear you.	Jie negali tavęs girdėti.
This apple is sweet.	Šis obuolys yra saldus.
This table is heavy.	Šis stalas yra sunkus.
Tom changed clothes.	Tomas persirengė.
Tom died in my arms.	Tomas mirė mano rankose.
Tom is not an idiot.	Tomas ne idiotas.
Tom raised his hand.	Tomas pakėlė ranką.
Tom wasn't arrested.	Tomas nebuvo areštuotas.
Translate this text.	Išverskite šį tekstą.
We wanted to listen.	Jie norėjo klausyti.
We're all different.	Mes visi esame skirtingi.
Where's the midwife?	Kur yra akušerė?
Whose house is this?	Kieno yra šis namas?
Why is the sky blue?	Kodėl dangus mėlynas?
You are always late.	Tu visada vėluoji.
You ate my sandwich.	Tu suvalgei mano sumuštinį.
You can count on me.	Gali manimi pasikliauti.
You can count on me.	Galite manimi pasikliauti.
You can't defeat me.	Negali manęs nugalėti.
You can't defeat me.	Tu negali manęs nugalėti.
You will need a key.	Tau prireiks rakto.
You're not laughing.	Tu nesijuoki.
Are you able to type?	Ar Jūs mokate rašyti spausdinimo mašinėle?
Can I ask a question?	Ar galiu užduoti klausimą?
Can you fix our sink?	Ar Jūs galite sutaisyti mūsų kriauklę?
Don't play with fire.	Nežaisk su ugnimi.
Don't play with fire.	Nežaiskite su ugnimi.
Don't you like girls?	Ar jums nepatinka merginos?
Don't you like girls?	Ar tau nepatinka merginos?
Go to the barbershop.	Nueik į kirpyklą.
Go to the barbershop.	Nueik pas kirpėją.
He always plays well.	Jis visada gerai žaidžia.
He begged me to stay.	Jis maldavo manęs likti.
He is a fast speaker.	Jis greitai kalba.
He is lazy by nature.	Jis tingus iš prigimties.
He is my best friend.	Jis mano geriausias draugas.
He is my best friend.	Ji mano geriausia draugė.
He is small and weak.	Jis mažas ir silpnas.
I am no longer tired.	Nebesu pavargęs.
I am no longer tired.	Nebesu pavargusi.
I am terribly hungry.	Esu baisiai išalkęs.
I am terribly hungry.	Esu baisiai išalkusi.
I asked her to dance.	Pakviečiau ją pašokti.
I came here to learn.	Aš atėjau čia mokytis.
I can't see anything.	Aš nieko nematau.
I didn't meet anyone.	Aš nieko nesutikau.
I dislike big cities.	Aš nemėgstu didelių miestų.
I gave Tom a blanket.	Aš daviau Tomui antklodę.
I know all about you.	Aš žinau apie tave viską.
I left you a message.	Aš palikau tau pranešimą.
I like your optimism.	Man patinka jūsų optimizmas.
I like your optimism.	Man patinka tavo optimizmas.
I love your daughter.	Aš myliu jūsų dukrą.
I now agree with Tom.	Dabar aš pritariu Tomui.
I was adopted by Tom.	Tomas mane įsivaikino.
I was at the library.	Aš buvau bibliotekoje.
I won't work for you.	Aš nedirbsiu tau.
I'll be very careful.	Aš busiu labai atsargus.
I'll be very careful.	Busiu labai atsargi.
I'm right behind you.	Aš tiesiai už tavęs.
I'm tired of driving.	Aš pavargau vairuodamas.
I'm tired of driving.	Aš nuvargau vairuodamas.
I'm tired of driving.	Aš pailsau vairuodamas.
I've already done it.	Aš jau tai padariau.
It was an awful week.	Buvo siaubinga savaitė.
It's all Tom's fault.	Tai Tomas dėl visko kaltas.
May I borrow this CD?	Ar galėčiau pasiskolinti šį CD?
Monkeys like bananas.	Beždžionės mėgsta bananus.
My mother was crying.	Motina verkė.
People are so stupid.	Žmonės tokie kvaili.
Please don't go away.	Prašau, neišeik.
Please open this box.	Prašau atidaryk čia dėžę.
Please open this box.	Prašau atidarykite šią dėžę.
Tell Tom to write me.	Pasakyk Tomui, kad man parašytų.
That can't be denied.	Tai nepaneigiama.
That's all I can ask.	Tai viskas, ko aš galiu paklausti.
They exchanged gifts.	Jie apsikeitė dovanomis.
They're not a threat.	Jie nekelia grėsmės.
This is now our home.	Dabar tai mūsų namai.
Tom broke up with me.	Tomas išsiskyrė su manimi.
Tom has lost control.	Tomas prarado kontrolę.
Tom has lost control.	Tomas tapo nekontroliuojamas.
Tom is a great actor.	Tomas yra puikus aktorius.
Tom is a voice actor.	Tomas yra įgarsintojas.
Tom is an eye doctor.	Tomas yra akių gydytojas.
Tom is an eye doctor.	Tomas yra okulistas.
Tom is not religious.	Tomas nereligingas.
Tom isn't unemployed.	Tomas ne bedarbis.
Tom knows he's right.	Tomas žino, kad jis yra teisus.
We're leaving Boston.	Mes paliekame Bostoną.
What do you see here?	Ką jūs čia matote?
What do you see here?	Ką tu čia matai?
What is your address?	Koks jūsų adresas?
What should I do now?	Ką dabar aš turiu daryti?
Where are my parents?	Kur mano tėvai?
Which one is cheaper?	Kuris yra pigesnis?
Why are you so angry?	Kodėl tu taip pyksti?
Why did Tom buy that?	Kam Tomas tai nupirko?
You can count on him.	Gali juo pasitikėti.
You can count on him.	Gali juo pasikliauti.
You can't just leave.	Tu negali tiesiog išeiti.
You will be punished.	Tu busi nubaustas.
You're afraid of him.	Tu jo bijai.
Come home before dark.	Grįžk namo prieš tamsą.
Complete the sentence.	Pabaik sakinį.
Dancing is prohibited.	Šokti draudžiama.
Don't forget your bag.	Nepamiršk savo krepšio.
Don't leave the TV on.	Nepalikite televizoriaus įjungto.
Don't leave the TV on.	Nepalik televizoriaus įjungto.
Fortune smiled on him.	Sėkmė jam nusišypsojo.
Have you seen my wife?	Ar matėte mano žmoną?
Have you seen my wife?	Ar matei mano žmoną?
Have you seen my wife?	Ar nematėte mano žmonos?
Have you seen my wife?	Ar nematei mano žmonos?
He gets a high salary.	Jis gauna didelę algą.
He is wearing glasses.	Jis nešioja akinius.
How do you explain it?	Kaip tu tai paaiškintum?
How do you explain it?	Kaip jūs tai paaiškintumėte?
How long ago was that?	Kaip seniai tai buvo?
How long can you stay?	Kiek ilgai gali pasilikti?
How long can you stay?	Kiek ilgai galite pasilikti?
I always wanted a dog.	Aš visada norėjau šuns.
I am not studying now.	Aš dabar nesimokau.
I am not studying now.	Aš dabar nestudijuoju.
I am talking with Tom.	Aš kalbu su Tomu.
I am tired of my work.	Aš pavargau nuo darbo.
I can do it by myself.	Aš galiu tai padaryti pats.
I can do it by myself.	Aš galiu tai padaryti pati.
I don't care for beer.	Aš nemėgstu alaus.
I fell off the ladder.	Aš nukritau nuo kopėčių.
I have met her before.	Aš jau buvau ją sutikęs.
I have three children.	Aš turiu tris vaikus.
I hid behind the tree.	Aš pasislėpiau už medžio.
I know it was strange.	Žinau, kad tai buvo keista.
I might've been wrong.	Aš galėjau klysti.
I might've been wrong.	Aš galėjau suklysti.
I promise not to sing.	Pažadu nedainuoti.
I squeezed Tom's hand.	Aš suspaudžiau Tomo ranką.
I squeezed Tom's hand.	Aš paspaudžiau ranką Tomui.
I suggest you ask Tom.	Siūlau jums paklausti Tomo.
I want to talk to you.	Aš noriu pasikalbėti su tavimi.
I was told to go home.	Man buvo pasakyta eiti namo.
I wasn't driving fast.	Aš nevažiavau greitai.
I'd like to buy a map.	Norėčiau nusipirti žemėlapį.
I'm not a good person.	Aš nesu geras žmogus.
I'm not afraid at all.	Aš visiškai nebijau.
I'm not angry anymore.	Aš nebepykstu.
I've been busy lately.	Pasaruoju metu aš buvau užsiėmęs.
I've been to the bank.	Aš buvau nuėjęs į banką.
I've been to the bank.	Aš buvau nuėjusi į banką.
I've got one of these.	Aš vieną jų turiu.
Is Tom very mad at me?	Ar Tomas ant manęs labai pyksta?
Is this your umbrella?	Ar tai tavo skėtis?
Is this your umbrella?	Ar tai jūsų skėtis?
It could still happen.	Tai dar gali įvykti.
It reminded me of you.	Tai man priminė tave.
It's a cultural thing.	Tai priklauso nuo kultūros.
It's abundantly clear.	Tai akivaizdu.
Leave my family alone.	Palik mano šeimą ramybėje.
Let's speak in French.	Kalbėkime prancūziškai.
My left arm is asleep.	Mano kairė ranka nutirpo.
Resources are limited.	Ištekliai riboti.
She didn't say a word.	Ji nepasakė nė žodžio.
That brown hat is old.	Ši ruda skrybelė yra sena.
That car is very fast.	Ši mašina labai greita.
That may be dangerous.	Tai gali būti pavojinga.
That's true, isn't it?	Tai tiesa, ar ne?
That's what I thought.	Taip ir maniau.
They don't understand.	Jie nesupranta.
They want us to do it.	Jie nori, kad mes tai padarytume.
Tom and Mary survived.	Tomas ir Merė išliko gyvi.
Tom is a handsome man.	Tomas - gražus vyras.
Tom is counting money.	Tomas skaičiuoja pinigus.
Tom isn't a Capricorn.	Tomas ne Ožiaragis.
Tom knows who Mary is.	Tomas žino, kas yra Mary.
Tom likes skiing, too.	Tomas taip pat mėgsta slidinėti.
Tom threw Mary a rope.	Tomas metė Merei virvę.
Tom was given a medal.	Tomas gavo medalį.
Tom wasn't a diplomat.	Tomas diplomatu nebuvo.
Tom watched a cartoon.	Tomas žiūrėjo animacinį filmuką.
Tom's shirt is drying.	Tomo marškiniai džiūva.
What they say is true.	Tai, ką jie sako, yra tiesa.
What's in these boxes?	Kas yra tose dėžėse?
Where are the cookies?	Kur sausainiai?
Where are you staying?	Kur tu apsistojęs?
Where are you staying?	Kur jūs apsistoję?
You came home at 5:00.	Tu namo atėjai penktą.
You need to work fast.	Tu turi greitai dirbti.
You should believe me.	Tu turi manimi tikėti.
You weren't listening.	Tu nesiklausei.
A wolf cannot be tamed.	Vilko neįmanoma prisijaukinti.
Better late than never.	Geriau vėliau, negu niekada.
Can I get back to work?	Ar aš galiu grįžti prie darbo?
Could you gift wrap it?	Ar galite suvynioti kaip dovaną?
Did you want to see me?	Norėjai pasimatyti su manim?
Do you want to be rich?	Ar nori būti turtingas?
Do you want to be rich?	Ar nori būti turtinga?
Do you want to be rich?	Ar norite būti turtingi?
Does Tom know who I am?	Ar Tomas žino, kas aš esu?
Don't buy Tom anything.	Nepirk nieko Tomui.
Don't release that dog.	Nepaleiskite to šuns.
Everyone loves puppets.	Visi mėgsta lėles.
He demanded better pay.	Jis reikalavo didesnio atlyginimo.
He learned how to swim.	Jis išmoko plaukti.
He won the third prize.	Jis laimėjo trečią prizą.
How do you want to die?	Kaip tu nori mirti?
How do you want to die?	Kaip jūs norite mirti?
I don't agree with you.	Aš nesutinku su tavimi.
I don't agree with you.	Aš nesutinku su jumis.
I have a lot of dreams.	Aš turiu daug svajonių.
I have nothing to lose.	Man nėra ko prarasti.
I hope to see you soon.	Tikiuosi greitai jus pamatyti.
I live with my parents.	Aš gyvenu kartu su tėvais.
I saw a beautiful bird.	Aš mačiau nuostabų paukštį.
I think Tom likes Mary.	Manau, kad Tomui patinka Merė.
I was very tired today.	Šiandien aš buvau labai pavargęs.
I was very tired today.	Šiandien aš buvau labai pavargusi.
I won't live like that.	Aš taip negyvensiu.
I'm sure it's personal.	Esu įsitikinęs, kad tai yra asmeniška.
I've been very foolish.	Aš buvau labai kvailas.
I've been very foolish.	Aš buvau itin kvailas.
Is this seat available?	Ar ši vieta laisva?
It's what I want to do.	Tai yra tai, ką aš noriu daryti.
Let's ask if it's true.	Pasiteiraukim, ar tai tiesa.
Let's ask if it's true.	Paklauskim, ar tai tiesa.
Luckily nobody got wet.	Laimei niekas nesušlapo.
Mary is very beautiful.	Merė labai graži.
My left foot is asleep.	Mano kairė pėda nutirpo.
My son has a toothache.	Mano sūnui skauda dantį.
Nobody's indispensable.	Nepakeičiamų žmonių nėra.
She can speak Japanese.	Ji moka kalbėti japoniškai.
She tore up the letter.	Ji sudraskė laišką.
The cat is on the roof.	Katė yra ant stogo.
The room is warming up.	Kambarys sušyla.
They looked very happy.	Jie atrodė labai laimingi.
Tom has to go home now.	Tomas dabar turi eiti namo.
Tom is in great danger.	Tomas yra didžiuliame pavojuje.
Tom is just warming up.	Tomas dar tik apšyla.
Tom is milking the cow.	Tomas melžia karvę.
Tom isn't an anarchist.	Tomas ne anarchistas.
Tom looks like a woman.	Tomas atrodo kaip moteris.
We did all we could do.	Padarėme viską, ką galėjome.
We want to talk to Tom.	Mes norime pasikalbėti su Tomu.
What a bunch of idiots!	Kas per idiotų gauja!
What are you two doing?	Ką judu veikiate?
When did you find this?	Kada tu tai radai?
Who are you talking to?	Su kuo tu kalbi?
Who are you talking to?	Į ką tu kreipiesi?
Why did they search us?	Kodėl mus apieškojo?
Why don't you watch TV?	Kodėl tu nežiūri televizoriaus?
Will you drive me home?	Ar nuveši mane namo?
Will you drive me home?	Ar nuvešite mane namo?
You can't count on him.	Negali juo pasitikėti.
You can't count on him.	Negalima pasitikėti juo.
You need patience, Tom.	Tau reikia kantrybės, Tomai.
You need to stay alert.	Privalai likti budrus.
You said it was urgent.	Tu sakei, kad tai skubu.
You'll lose everything.	Tu viską prarasi.
A mirror reflects light.	Veidrodis atspindi šviesą.
Are there any survivors?	Ar kas nors išgyveno?
Are there any survivors?	Ar yra išgyvenusiųjų?
Come and give me a kiss.	Prieik ir pabučiuok mane.
Did you see their faces?	Ar tu matei jų veidus?
Don't avoid my question.	Nevenk mano klausimo.
Don't avoid my question.	Nevenkite mano klausimo.
Don't call Tom an idiot.	Nevadinkite Tomo idiotu.
Don't call Tom an idiot.	Nevadink Tomo idiotu.
Don't play dumb with us.	Nevaidink kvailio su mumis.
Don't touch my sandwich.	Neliesk mano sumuštinio!
Goodbyes are always sad.	Atsisveikinimai visada būna liūdni.
He barely escaped death.	Jis vos išvengė mirties.
He is no longer a child.	Jis jau nebe vaikas.
He turned off the light.	Jis išjungė šviesą.
He turned off the light.	Jis užgesino šviesą.
He's always complaining.	Jis nuolatos skundžiasi.
How long is this bridge?	Koks yra šio tilto ilgis?
I accept that challenge.	Aš priimu iššūkį.
I called off my wedding.	Aš atšaukiau savo vestuves.
I didn't steal anything.	Aš nieko nepavogiau.
I didn't want the money.	Aš nenorėjau pinigų.
I didn't write anything.	Nieko neparašiau.
I don't like sad movies.	Aš nemėgstu liūdnų filmų.
I enjoy taking pictures.	Man patinka fotografuoti.
I knew what I was doing.	Žinojau, ką dariau.
I know his brother well.	Aš gerai pažįstu jo brolį.
I know what his name is.	Aš žinau jo vardą.
I should've worn a coat.	Aš turėjau vilkėti paltą.
I want to see the movie.	Noriu pamatyti šį filmą.
I was invited to dinner.	Mane pakvietė pietų.
I'll be glad to do that.	Aš mielai tai padaryčiau.
I'm just looking around.	Aš tik žiūriu.
I'm not as lucky as you.	Nesu toks sėkmingas kaip tu.
I'm on the eighth floor.	Esu aštuntame aukšte.
Is smoking allowed here?	Ar čia galima rūkyti?
It rained all last week.	Visą praeitą savaitę lijo.
It wasn't a coincidence.	Tai nebuvo sutapimas.
It's a stupid tradition.	Tai kvaila tradicija.
May I ask you something?	Ar galiu tavęs kai ko paklausti?
May I ask you something?	Ar galiu jūsų kai ko paklausti?
May I have a cup of tea?	Ar galėčiau gauti puodelį arbatos?
Money can't buy friends.	Pinigai negali nupirkti draugų.
My mother must be angry.	Mano mama turi būti pikta.
Never talk to strangers.	Niekada nekalbėk su nepažįstamais.
Nobody's looking for us.	Mūsų niekas neieško.
Please close the window.	Prašau, uždaryk langą.
Tell me about your wife.	Papasakok man apie savo žmoną.
That isn't what I meant.	Tai nėra tai, ką turėjau omenyje.
That movie was terrible.	Filmas buvo siaubingas.
That wasn't my question.	Tai nebuvo mano klausimas.
That's a brilliant idea.	Tai puiki mintis.
That's a brilliant idea.	Tai yra puiki mintis.
That's a brilliant idea.	Puiki mintis.
The key is on the table.	Raktas guli ant stalo.
The trip was exhausting.	Kelionė buvo varginanti.
The universe is endless.	Visata yra beribė.
The walls are very thin.	Sienos yra labai plonos.
This battery is charged.	Ši baterija pakrauta.
Tom and Mary seem happy.	Tomas ir Merė atrodo laimingi.
Tom asked for my advice.	Tomas paprašė mano patarimo.
Tom doesn't like soccer.	Tomas nemėgsta futbolo.
Tom is my older brother.	Tomas- mano vyresnysis brolis.
Tom is riding a bicycle.	Tomas važiuoja dviračiu.
Tom now lives in Boston.	Tomas dabar gyvena Bostone.
Tom seemed to like that.	Atrodė, kad tai patinka Tomui.
We'll take care of this.	Mes tuo pasirūpinsime.
Were there any problems?	Ar iškilo kokių nors problemų?
What color is your hair?	Kokios spalvos yra tavo plaukai?
What does he want to do?	Ką jis nori daryti?
Which one do you prefer?	Kuriam tu teiki pirmenybę?
Which one do you prefer?	Kuriam jūs teikiate pirmenybę?
Which one do you prefer?	Kuris tau labiau patinka?
Which one do you prefer?	Kuris jums labiau patinka?
Who ate all the cookies?	Kas suvalgė visus sausainius?
Why can't Tom stay here?	Kodėl Tomas negali čia pasilikti?
You can go to sleep now.	Dabar gali eiti miegoti.
You can go to sleep now.	Dabar galite eiti miegoti.
You can hear everything.	Tu gali viską girdėti.
You don't have the time.	Jūs neturite laiko.
You have done very well.	Šauniai pasidarbavai.
You're a beautiful girl.	Tu esi graži mergina.
A cow is a useful animal.	Karvė yra naudingas gyvūnas.
Are you really not going?	Ar tu tikrai neini?
Did you pay for the book?	Ar sumokėjai už knygą?
Do I have to do this now?	Ar aš tai turiu padaryti dabar?
Do we have enough chairs?	Ar turime užtektinai kėdžių?
Do we have enough chairs?	Ar mums užtenka kėdžių?
Do you know who they are?	Ar žinai, kas jie?
Do you love your country?	Ar tu myli savo šalį?
Do you love your country?	Ar jūs mylite savo šalį?
Does Tom have experience?	Ar Tomas turi patirtį?
Everybody but Tom smiled.	Visi, išskyrus ją, nusišypsojo.
Get out of the classroom.	Išeik iš klasės.
He is certain to succeed.	Jam būtinai pasiseks.
How can you not like him?	Kaip tu gali jo nemėgti?
I agreed to the proposal.	Aš pritariau šiam pasiūlymui.
I agreed to the proposal.	Aš sutikau su šiuo pasiūlymu.
I am afraid he will fail.	Bijau, kad jam nepavyks.
I am just warming up now.	Aš dabar tik apšylu.
I don't know his address.	Aš nežinau jo adreso.
I got lost in the forest.	Aš pasiklydau miške.
I have a good dictionary.	Aš turiu gerą žodyną.
I have a lot of homework.	Aš turiu daug namų darbų.
I have a stupid question.	Turiu kvailą klausimą.
I knew you'd like Boston.	Žinojau, kad tau patiks Bostonas.
I knew you'd like Boston.	Žinojau, kad jums patiks Bostonas.
I know both of the girls.	Aš pažįstu abi mergaites.
I miss the good old days.	Ilgiuosi senų gerų dienų.
I miss the good old days.	Pasiilgau senų gerų dienų.
I saw her enter the room.	Mačiau ją įeinančią į kambarį.
I saw him enter the room.	Mačiau jį įeinantį į kambarį.
I usually walk to school.	Į mokyklą paprastai einu pėsčias.
I usually walk to school.	Į mokyklą paprastai einu pėsčia.
I was ushered to my seat.	Buvau palydėtas prie savo vietos.
I will never do it again.	Niekada daugiau to nedarysiu.
I'll stay here for a bit.	Aš kurį laiką pabusiu čia.
I'm in a better mood now.	Dabar aš jaučiuosi geriau.
I'm in a good mood today.	Mano nuotaika šiandien yra gera.
I'm not much of a singer.	Aš nesu labai geras daininkas.
I'm proud of all of them.	Aš didžiuojuosi jais visais.
I'm trying something new.	Aš bandau kai ką naujo.
I'm trying to understand.	Aš bandau suprasti.
I'm very happily married.	Aš labai laimingai susituokęs.
I've got nothing to lose.	Man nėra ko prarasti.
I've never believed that.	Aš niekuomet netikėjau tuo.
It's 7:50 in the morning.	Dabar yra be dešimties minučių aštuonios.
It's 7:50 in the morning.	Dabar septynios valandos ir penkiasdešimt minučių.
Japan has a mild climate.	Japonijos klimatas yra švelnus.
Just answer the question.	Tiesiog atsakyk į klausymą.
Let me ask you something.	Leisk tavęs kai ko paklausti.
Let me introduce my wife.	leiskite pristatyti mano žmoną.
Please turn on the radio.	Prašau, įjunk radiją.
She did not say anything.	Ji nieko nepasakė.
She has married a nobody.	Ji ištekėjo už nieko.
She has no sense of duty.	Ji neturi jokio pareigos jausmo.
She took him to the lake.	Ji nuvedė jį prie ežero.
She wants to read a book.	Ji nori skaityti knygą.
Take Tom to the hospital.	Nuvežk Tomą į ligoninę.
Ten years is a long time.	Dešimt metų yra ilgas laikas.
The meat's not ready yet.	Mėsa dar neparuošta.
The snow is falling fast.	Sniegas greitai krenta.
The soup is terribly hot.	Sriuba nepaprastai karšta.
The waves are high today.	Bangos yra aukštos šiandien.
There's just one problem.	Yra tik viena problema.
They can't stop laughing.	Jie negali nustoti juoktis.
This is for internal use.	Tai skirta vidiniam naudojimui.
This is going to be easy.	Tai bus lengva.
This is not very stylish.	Tai nėra labai stilinga.
This is really delicious.	Tai išties labai gardu.
Today is a beautiful day.	Šiandien graži diena.
Tom asked Mary for money.	Tomas paprašė Merės pinigų.
Tom asked for more money.	Tomas paprašė daugiau pinigų.
Tom asked where you were.	Tomas klausė, kur tu buvai.
Tom didn't know her name.	Tomas nežinojo jos vardo.
Tom fell off his bicycle.	Tomas nukrito nuo dviračio.
Tom is reading the Bible.	Tomas skaito Bibliją.
Tom isn't a pediatrician.	Tomas ne pediatras.
Tom sure can play tennis.	Tomas tikrai gali žaisti tenisą.
Use your other hand, too.	Naudok savo kitą ranką taip pat.
We appreciate his talent.	Mes vertiname jo talentą.
We appreciate his talent.	Mes pripažįstame jo talentą.
We have common interests.	Mes turime bendrų interesų.
We talked the night away.	Visą naktį praleidome kalbėdamiesi.
We talked the night away.	Visą naktį praleidome šnekėdamiesi.
We talked the night away.	Mes kalbėjomės visą naktį.
Who is playing the piano?	Kas skambina pianinu?
Why is Tom still popular?	Kodėl Tomas yra vis dar populiarus?
Why isn't Tom helping us?	Kodėl Tomas mums nepadeda?
Why isn't Tom in the car?	Kodėl Tomo nėra mašinoje?
Why isn't Tom in the car?	Kodėl Tomas ne mašinoje?
Wine is made from grapes.	Vynas yra daromas iš vynuogių.
Your book is on the desk.	Tavo knyga yra ant stalo.
Your book is on the desk.	Tavo knyga yra ant suolo.
A nail punctured the tire.	Vinis pradūrė padangą.
Are you looking for a job?	Ar Jūs ieškote darbo?
Can you come to the party?	Ar gali ateiti į vakarėlį?
Did you find your letters?	Ar radai savo laiškus?
Did you find your letters?	Ar radote savo laiškus?
Did you get Tom's message?	Ar tu gavai Tomo žinutę?
Did you get Tom's message?	Ar jūs gavote Tomo žinutę?
Did you just realize that?	Jūs tik dabar supratote?
Do you know Tom's address?	Ar žinote Tomo adresą?
Do you know Tom's address?	Ar žinai Tomo adresą?
Do you know Tom's parents?	Ar jūs pažįstate Tomo tėvus?
Do you know Tom's parents?	Ar tu pažįsti Tomo tėvus?
Do you know their address?	Žinai jų adresą?
Do you think I don't care?	Manai, man tai nesvarbu?
Do you think I don't care?	Galvoji, kad man tai nerūpi?
Don't be afraid of change.	Nebijok permainų.
Don't be afraid of change.	Nebijokite permainų.
Don't let him do it alone.	Neleisk jam to daryti vienam.
He fixed the broken table.	Jis sutaisė sulūžusį stalą.
He's sleeping like a baby.	Miega kaip kūdikis.
He's wanted by the police.	Jis yra ieškomas policijos.
He's wanted by the police.	Jo ieško policija.
I accepted his invitation.	Aš priėmiau jo kvietimą.
I actually liked it a lot.	Iš tiesų, man tai labai patiko.
I can win. I'm sure of it.	Aš galiu laimėti. Aš esu tikras dėl to.
I couldn't live like that.	Aš negalėčiau taip gyventi.
I don't have your address.	Aš neturiu jūsų adreso.
I don't have your address.	Aš neturiu tavo adreso.
I don't like scary movies.	Aš nemėgstu baisių filmų.
I don't like scary movies.	Aš nemėgstu siaubo filmų.
I don't understand German.	Aš nesuprantu vokiškai.
I don't understand German.	Aš nesuprantu vokiečių kalbos.
I got the ticket for free.	Gavau bilietą nemokamai.
I got up very early today.	Šiandien atsikėliau labai anksti.
I have a ten-year-old boy.	Turiu dešimties metų sūnų.
I hope Tom appreciates it.	Manau, Tomas tai įvertins.
I just want to be perfect.	Aš tik noriu būti tobulas.
I just want to be perfect.	Aš tik noriu būti tobula.
I like instrumental music.	Aš mėgstu instrumentinę muziką.
I watched TV this morning.	Šįryt aš žiūrėjau televizorių.
I watched TV this morning.	Šiandien ryte žiūrėjau televizorių.
I'll be there at five p.m.	Aš busiu ten penktą.
I'm going to buy a fridge.	Aš ketinu pirkti šaldytuvą.
I'm going to buy a fridge.	Aš žadu pirkti šaldytuvą.
I'm not talking about you.	Aš ne apie tave kalbu.
Life is full of mysteries.	Gyvenimas pilnas paslapčių.
Most students like sports.	Dauguma studentų mėgsta sportą.
My right foot is sleeping.	Man nutirpo dešinė pėda.
People don't live forever.	Žmonės negyvena amžinai.
She lives in a huge house.	Ji gyvena milžiniškame name.
She was afraid of the dog.	Ji išsigando šuns.
Some people never grow up.	Kai kurie žmonės niekada nesuauga.
Someone stole my passport.	Kažkas pavogė mano pasą.
Stay away from that place.	Laikykis atokiai nuo tos vietos.
Stay away from that place.	Laikykites atokiai nuo tos vietos.
Thank you for coming back.	Ačiū, kad grįžai.
That's what I'm afraid of.	Va šito aš ir bijau.
The bullet found its mark.	Kulka pataikė į taikinį.
The kitten wants to sleep.	Kačiukas nori miego.
They didn't pay attention.	Jie neatkreipė dėmesio.
They missed a good chance.	Jie praleido puikią progą.
They won't get the chance.	Jie negaus šanso.
They won't get the chance.	Jie negaus galimybės.
This desk is made of wood.	Šis stalas pagamintas iš medienos.
This glass contains water.	Šioje stiklinėje yra vandens.
Tom and Mary went outside.	Tomas ir Merė išėjo į lauką.
Tom doesn't eat much meat.	Tomas nevalgo daug mėsos.
Tom doesn't want to leave.	Tomas nenori išeiti.
Tom is asleep in his room.	Tomas miega savo kambaryje.
Tom said you speak French.	Tomas sakė, kad tu kalbi prancūziškai.
Tom seems different today.	Šiandien Tomas atrodo kitaip.
We have limited resources.	Mūsų ištekliai yra riboti.
We saw her enter the park.	Matėme ją įeinančią į parką.
We saw her enter the park.	Matėme, kaip ji įėjo į parką.
We want to know the facts.	Mes norime žinoti faktus.
We're here to protect you.	Mes čia tam, kad tave apgintume.
What time did you wake up?	Kelintą valandą pabudai?
What's your favorite food?	Koks jūsų mėgstamiausias valgis?
What's your favorite food?	Koks tavo mėgstamiausias valgis?
Why won't he listen to me?	Kodėl jis manęs neklausys?
Will you warm up the soup?	Ar gali pašildyti sriubą?
You can't leave this room.	Jums negalima išeiti iš šio kambario.
You should be proud of me.	Tu turi manim didžiuotis.
Animals are afraid of fire.	Gyvūnai bijo ugnies.
China is bigger than Japan.	Kinija didesnė už Japoniją.
China is bigger than Japan.	Kinija didesnė, nei Japonija.
Do you have any objections?	Ar turite kokių nors prieštaravimų?
Dreams sometimes come true.	Kartais svajonės išsipildo.
Drive with the utmost care.	Vairuok ypač atsargiai
Everything is done by hand.	Viskas daroma rankomis.
He calculated the expenses.	Jis paskaičiavo nuostolius.
He comes here twice a week.	Jis ateina čia du kartus per savaitę.
He grew up in a small town.	Ji užaugo mažame miestelyje.
He grew up in a small town.	Jis užaugo mažame miestelyje.
He kissed her on the cheek.	Jis pabučiavo ją į skruostą.
He knows how to play poker.	Jis žino, kaip žaisti pokerį.
He slipped and nearly fell.	Jis slystelėjo ir vos nepargriuvo.
He started washing his car.	Jis ėmė plauti savo mašiną.
I arrived in Tokyo at noon.	Atvykau į Tokiją perpiet.
I can't predict the future.	Aš negaliu numatyti ateities.
I didn't have any problems.	Aš neturėjau jokių problemų.
I guess I'll see you later.	Spėju pamatysiu tave vėliau.
I hope it's sunny tomorrow.	Tikiuosi, rytoj bus saulėta.
I just changed my password.	Aš ką tik pasikeičiau slaptažodį.
I knew this was a bad idea.	Žinojau, kad tai bloga idėja.
I need somebody to talk to.	Man reikia su kažkuo pasikalbėti.
I prefer apples to oranges.	Obuoliai man patinka labiau už apelsinus.
I think that's a good idea.	Manau, kad tai gera idėja.
I think we should call Tom.	Aš manau, kad turime paskambinti Tomui.
I wonder why Tom said that.	Įdomu, kodėl Tomas taip pasakė.
I'll know better next time.	Kitą kartą žinosiu geriau.
I'll never leave you again.	Aš niekada daugiau tavęs nepaliksiu.
I'll send the book by mail.	Aš išsiųsiu knygą paštu.
I'm not certain what to do.	Aš nesu tikras, ką daryti.
I'm not certain what to do.	Aš nesu tikra, ką daryti.
I'm really bored right now.	Dabar tikrai nuobodžiauju.
I've been very busy lately.	Paskutiniu metu buvau labai užsiėmusi.
I've been very busy lately.	Paskutiniu metu buvau labai užsiėmęs.
I've done this all my life.	Aš tai dariau visą gyvenimą.
Mary is helping her mother.	Merė padeda savo mamai.
My mother's feeling better.	Mano motina jaučiasi geriau.
Nobody's ever heard of him.	Niekas niekada nėra apie jį girdėjęs.
Nobody's going to hurt you.	Niekas tavęs nenuskriaus.
Read the message once more.	Perskaityk pranešimą dar kartą.
She greeted him cheerfully.	Ji sutiko jį džiugiai.
She turned around suddenly.	Staiga ji apsidairė.
That isn't the best answer.	Tai nėra geriausias atsakymas.
That's not the best answer.	Tai nėra geriausias atsakymas.
That's what I want to hear.	Tai yra tai, ką aš noriu išgirsti.
That's what I want to hear.	Štai ką aš noriu išgirsti.
The moon has no atmosphere.	Mėnulyje nėra atmosferos.
The movie's about to start.	Filmas tuoj prasidės.
There's always a next time.	Visada yra kitas kartas.
There's blood in the water.	Vandenyje yra kraujo.
There's no air on the moon.	Mėnulyje nėra oro.
There's no one in the room.	Kambaryje nieko nėra.
This gift is for my friend.	Ši dovana skirta mano draugui.
Tom couldn't stop sneezing.	Tomas negalėjo nustoti čiaudėti.
Tom is a comic book writer.	Tomas yra komiksų autorius.
Tom never wanted to try it.	Tomas niekada nenorėjo to pabandyti.
Tom never wanted to try it.	Tomas niekada nenorėjo to išbandyti.
Tom's death was unexpected.	Tomo mirtis buvo netikėta.
Tom's death was unexpected.	Tomo mirtis buvo nelaukta.
We used to be best friends.	Mes buvome geriausi draugai.
What a terrible experience!	Kokia baisi patirtis.
What does Tom want from me?	Ko Tomas iš manęs nori?
What does it remind you of?	Ką tau tai primena?
What does it remind you of?	Ką jums tai primena?
What's your Skype username?	Koks tavo skaipo vardas?
What's your Skype username?	Koks tavo skaipo adresas?
Where are you calling from?	Iš kur skambini?
Without you, life is awful.	Be tavęs gyvenimas siaubingas.
You must've done something.	Tu tikriausiai kažką padarei.
Your dreams have come true.	Tavo svajonės išsipildė.
All human beings are mortal.	Visi žmonės mirtingi.
Are you looking for someone?	Ar tu ko nors ieškai?
Are you looking for someone?	Ar jūs ko nors ieškote?
Are you ready for Halloween?	Ar esi pasiruošęs Helovinui?
Are you ready for Halloween?	Ar jūs pasiruošę Helovinui?
Are you ready for Halloween?	Ar esi pasiruošusi Helovinui?
Do you think I went too far?	Manote, kad aš užėjau per toli?
Do you want to learn French?	Nori mokytis prancūzų kalbos?
Doesn't that prove anything?	Argi tai nieko neįrodo?
Don't you want a cup of tea?	Ar norėtum puodelio arbatos?
English is studied in Japan.	Japonijoje yra mokomasi anglų kalbos.
English is studied in Japan.	Japonijoje studijuojama anglų kalba.
Everybody is busy except me.	Visi užsiėmę, išskyrus mane.
He is more clever than I am.	Jis gudresnis už mane.
He is more clever than I am.	Jis protingesnis, negu aš.
He used all available means.	Jis naudojosi visomis įmanomomis priemonėmis.
He's a well-informed person.	Jis yra gerai informuotas asmuo.
Her hair is naturally curly.	Jos plaukai iš prigimties garbanoti.
Her hair is naturally curly.	Jos plaukai yra natūraliai garbanoti.
How can you be so heartless?	Kaip gali būti toks beširdis?
How do you know where to go?	Kaip tu žinai, kur eiti?
How do you know where to go?	Kaip jūs žinote, kur eiti?
How long did you live there?	Kiek laiko ten gyvenai?
I agree with you absolutely.	Aš visiškai tau pritariu.
I agree with you absolutely.	Aš visiškai su jumis sutinku.
I agree with you absolutely.	Aš visiškai jums pritariu.
I bought a hat at the store.	Nusipirkau skrybėlę šioje parduotuvėje.
I can show you the pictures.	Aš galiu parodyti jums nuotraukas.
I can show you the pictures.	Aš galiu parodyti tau nuotraukas.
I don't have time right now.	Aš dabar neturiu laiko.
I exchanged yen for dollars.	Aš išsikeičiau jenas į dolerius.
I forgot to lock the drawer.	Aš pamiršau užrakinti stalčių.
I just don't have much time.	Aš tiesiog neturiu daug laiko.
I need someone to talk with.	Man reikia su kažkuo pasikalbėti.
I pushed Tom into the water.	Aš nustūmiau Tomą į vandenį.
I want to speak to a lawyer.	Norėčiau pasikalbėti su advokatu.
I was fortunate to see that.	Man pasisekė tai pamatyti.
I was scolded by my teacher.	Mokytojas išplūdo mane.
I was scolded by my teacher.	Gavau velnių nuo mokytojo.
I will do anything but that.	Padarysiu viską, tik ne tai.
I will not be busy tomorrow.	Rytoj nebūsiu užsiėmęs.
I will tell you about Japan.	Papasakosiu tau apie Japoniją.
I'd like to say a few words.	Norėčiau tarti porą žodžių.
I'd like to see your father.	Noriu susitikti su tavo tėvu.
I'm much older than you are.	Aš esu daug vyresnis už tave.
I'm used to staying up late.	Esu pripratęs eiti miegoti vėlai.
I'm used to staying up late.	Esu pripratusi eiti miegoti vėlai.
I'm used to staying up late.	Esu pripratęs sėdėti iki vėlumos.
I've never done that before.	Aš anksčiau niekada to nedariau.
Nature is full of mysteries.	Gamta pilna paslapčių.
Nobody was hungry except me.	Niekas nebuvo alkanas, išskyrus mane.
Our teacher is a real idiot.	Mūsų mokytoja tikra idiotė.
Our teacher is a real idiot.	Mūsų mokytojas tikras idiotas.
Reports are due next Monday.	Ataskaitas reikia pristatyti iki kito pirmadienio.
School reopens in September.	Rugsėjį mokyklose prasideda nauji mokslo metai.
She always dresses in black.	Ji visada rengiasi juodai.
She kissed him on the cheek.	Ji pabučiavo jį į skruostą.
Someone tried to poison Tom.	Kažkas bandė nunuodyti Tomą.
The doctor came immediately.	Gydytojas atėjo nedelsiant.
The dog is trying to escape.	Šuo bando išsivaduoti.
The printer had a paper jam.	Spausdintuve įstrigo popierius.
The same holds true for Tom.	Tas pats tinka ir Tomui.
Their flag is blue and gold.	Jų vėliava yra mėlynai-auksinė.
This is a comfortable chair.	Tai yra patogi kėdė.
Tom had a chance to do that.	Tomas turėjo progą tai padaryti.
Tom isn't who he says he is.	Tomas ne tas, kuo dedasi.
Tom liked his job very much.	Toniui labai patiko jo darbas.
Tom said he hated this book.	Tomas sakė, kad jis nekentė šios knygos.
Tom was killed by lightning.	Tomas žuvo nutrenktas žaibo.
Tom was killed by lightning.	Tomas žuvo į jį trenkus žaibui.
Tom will do the right thing.	Tomas padarys gerą dalyką.
Tom will get it figured out.	Tomas išsiaiškins tai.
Tom will look like an idiot.	Tomas atrodys kaip idiotas.
Tom will need to go further.	Tomas turės eiti toliau.
Tom will never let you down.	Tomas niekada neapvils tavęs.
Tom's attitude is excellent.	Tomo elgesys yra nuostabus.
Tom's comments are accurate.	Tomo komentarai yra tikslūs.
Tom's death was preventable.	Tomo mirtis buvo išvengiama.
Tom's wife left him in 2013.	Tomo žmona jį paliko 2013.
Wait, it could be dangerous.	Palauk, tai gali būti pavojinga.
We asked Tom about the list.	Mes paklausėme Tomo apie sąrašą.
We didn't want Tom to leave.	Mes nenorėjome, kad Tomas išvyktų.
We jammed into the elevator.	Mes susigrūdome į liftą.
We've already mentioned Tom.	Mes jau paminėjome Tomą.
We've arrived a little late.	Mes atvykome truputį pavėlavę.
What did you do this summer?	Ką veikei šią vasarą?
What does this mean for Tom?	Ką tai reiškia Tomui?
Where did you buy this book?	Kur pirkai šią knygą?
Where did you see the woman?	Kur jūs matėte šią moterį?
Where is the missing dollar?	Kur trūkstamas doleris?
Who's your favorite drummer?	Kas tavo mėgstamiausias būgnininkas?
Why are you doing that, Tom?	Kodėl tai darai, Tomai?
Why did you do what you did?	Kam jūs tai padarėte?
Why did you do what you did?	Kam tu tai padarei?
Will it be a difficult exam?	Ar tai bus sunkus egzaminas?
Will it be a difficult exam?	Ar egzaminas bus sunkus?
You can come if you want to.	Jūs galite ateiti, jei norite.
You can come if you want to.	Tu gali ateiti, jei nori.
You're making a big mistake.	Tu darai didžiulę klaidą.
Are you meeting someone here?	Susitiksi su kažkuo čia?
Can you believe what he said?	Ar gali patikėti tuo, ką jis pasakė?
Cooking is my secret passion.	Gaminimas yra mano slapta aistra.
Do you think Tom has changed?	Ar manai, kad Tomas pasikeitė?
Don't touch that blue button.	Nelieskite to mėlyno mygtuko.
Don't touch that blue button.	Neliesk šio mėlyno mygtuko.
Everything he said was right.	Vskas, ką jis sakė, buvo tiesa.
He came from Tokyo yesterday.	Vakar jis grįžo iš Tokijo.
He took out his handkerchief.	Jis ištraukė savo nosinę.
I came in through the window.	Aš įlipau per langą.
I came in through the window.	Aš patekau į vidų per langą.
I can recommend a good hotel.	Aš galiu parekomenduoti gerą viešbutį.
I can't answer your question.	Aš negaliu atsakyti į jūsų klausimą.
I can't answer your question.	Aš negaliu atsakyti į tavo klausimą.
I don't think it's important.	Nemanau, kad tai svarbu.
I don't understand this word.	Aš nesuprantu šio žodžio.
I haven't found a doctor yet.	Dar neradau daktaro.
I thought she was 30 at most.	Galvojau, kad jai daugiausiai trisdešimt metų.
I want to speak to my lawyer.	Norėčiau pasikalbėti su savo advokatu.
I will get up early tomorrow.	Rytoj aš kelsiuosi anksti.
I'll be back in half an hour.	Grįšiu po pusvalandžio.
I'm sorry for what I've done.	Atsiprašau už tai, ką padariau.
I've booked a table for four.	Aš rezervavau staliuką keturiems.
It doesn't matter what we do.	Nesvarbu, ką mes darome.
It is terrible weather today.	Šiandien oras siaubingas.
It's a very dangerous system.	Tai yra labai pavojinga sistema.
It's exactly half-past eight.	Lygiai pusė devynių.
Look at the book on the desk.	Žiūrėk į knygą ant stalo.
My car broke down on the way.	Mano mašina sugedo pakeliui.
Nobody can keep us apart now.	Dabar mūsų niekas neišskirs.
Nobody forced you to help me.	Niekas nevertė tavęs man padėti.
Our garden was full of weeds.	Mūsų sodas apaugo piktžolėmis.
She turned down our proposal.	Ji atmetė mūsų pasiūlymą.
She writes to him every week.	Ji rašo jam kiekvieną savaitę.
That's an interesting theory.	Tai idomi teorija.
That's what I've always said.	Ką aš visada ir sakiau.
The museum is worth visiting.	Muziejus yra vertas aplankymo.
The museum is worth visiting.	Muziejus vertas į jį nueiti.
The result was disappointing.	Rezultatas buvo nuviliantis.
The work is not finished yet.	Darbas dar nebaigtas.
There is going to be a storm.	Greit prasidės audra.
There is nothing to do today.	Šiandien nėra ką veikti.
There was a cat on the table.	Ant stalo buvo katė.
There's a cat under the desk.	Po suolu yra katė.
They are much taller than us.	Jie už mus kur kas aukštesni.
They are much taller than us.	Jie už mus gerokai aukštesni.
They are much taller than us.	Jie daug aukštesni už mus.
They do nothing but complain.	Jie daugiau nieko nedaro tik skundžiasi.
They forgot to lock the door.	Jie pamiršo užrakinti duris.
Tom asked Mary to quiet down.	Tomas paprašė Merės nusiraminti.
Tom didn't have enough money.	Tomas neturėjo pakankamai pinigų.
Tom spent three weeks in bed.	Tomas išgulėjo lovoje tris savaites.
Tom started yelling for help.	Tomas ėmė šaukti pagalbos.
Tom was sitting on the table.	Tomas sėdėjo ant stalo.
Was Tom the one who did this?	Ar tai Tomas padarė?
We can't live without oxygen.	Mes negalime išgyventi be deguonies.
We live close to the station.	Mes gyvename arti stoties.
We were one big happy family.	Mes buvome viena didelė laiminga šeima.
What will the newspapers say?	Ką pasakys spauda?
Why don't I have a boyfriend?	Kodėl aš neturiu vaikino?
You look very lovely tonight.	Šįvakar tu atrodai tiesiog žavingai.
You're a really sweet person.	Tu esi labai malonus žmogus.
You're a really sweet person.	Tu esi labai mielas žmogus.
You're a really sweet person.	Tu esi labai meilus žmogus.
Avoid fried foods for a while.	Kurį laiką venkite kepto maisto.
Dad, do you believe in ghosts?	Tėti, ar tiki vaiduokliais?
Dad, do you believe in ghosts?	Tėte, ar tiki vaiduokliais?
Do I have to answer in French?	Ar turiu atsakyti prancūziškai?
Do you enjoy living like this?	Jums patinka taip gyventi?
Do you enjoy living like this?	Tau patinka taip gyventi?
Does this have to be done now?	Ar tai turi būti padaryta dabar?
He is afraid that he will die.	Jis bijo, kad gali mirti.
He is afraid that he will die.	Jis bijo mirti.
He took advantage of my youth.	Jis pasinaudojo mano jaunumu.
He's not rich, but he's happy.	Jis nėra turtingas, bet jis laimingas.
How many siblings do you have?	Kiek tu turi brolių ir sesių?
I can't discuss that with you.	Negaliu diskutuoti su tavimi apie tai.
I don't like to make mistakes.	Man nepatinka klysti.
I gave some water to the dogs.	Aš daviau šunims šiek tiek vandens.
I got a letter from my friend.	Gavau laišką iš savo draugo.
I got a lot of mosquito bites.	Mane labai sukandžiojo uodai.
I know that he is watching me.	Aš žinau, kad jis mane stebi.
I learned to live without her.	Aš išmokau gyventi be jos.
I like to listen to the radio.	Mėgstu klausytis radijo.
I never want to see Tom again.	Aš daugiau niekada nenoriu Tomo matyti.
I thank you with all my heart.	Dėkoju tau iš visos širdies.
I thought I'd never hear that.	Galvojau, niekada to neišgirsiu.
I want to talk with my lawyer.	Norėčiau pasikalbėti su savo advokatu.
I wish I were a little taller.	Norėčiau būti truputį aukštesnis.
I wish I were a little taller.	Norėčiau būti truputį aukštesnė.
I'm going to make you a drink.	Padarysiu tau gėrimą.
I'm very proud of my daughter.	Aš labai didžiuojuosi savo dukra.
It was a really beautiful day.	Tai buvo išties nuostabi diena.
Let's go get a Christmas tree.	Įsigykime Kalėdų eglutę.
Most of his friends are girls.	Dauguma jo draugų yra mergaitės.
Most of his friends are girls.	Dauguma jo draugų yra merginos.
My mother never gets up early.	Mano mama niekada nesikelia anksti.
No one asked for your opinion.	Niekas neklausė tavo nuomonės.
Nobody asked for your opinion.	Niekas neklausė tavo nuomonės.
Please give me another chance.	Prašau, duok man dar vieną šansą.
Please give me another chance.	Prašau, suteikite man dar vieną galimybę.
She can speak three languages.	Ji moka tris kalbas.
She can speak three languages.	Ji kalba trimis kalbomis.
She plays tennis every Sunday.	Ji žaidžia tenisą kiekvieną sekmadienį.
She takes care of my children.	Ji prižiūri mano vaikus.
Somebody is playing the piano.	Kažkas groja fortepijonu.
Thank you for the information.	Ačiū už informaciją.
The weather is terrible today.	Šiandien oras siaubingas.
There is a cat in the kitchen.	Virtuvėje yra katė.
These scissors don't cut well.	Šios žirklės blogai kerpa.
They did not have enough gold.	Jie neturėjo pakankamai aukso.
This is the boy who helped me.	Štai tas berniukas, kuris padėjo man.
This just has to be Tom's hat.	Tai tiesiog privalo būti Tomo kepurė.
This size is too large for me.	Šis dydis man per per didelis.
Tom couldn't believe his ears.	Tomas negalėjo patikėti savo ausimis.
Tom is much smarter than I am.	Tomas daug protingesnis už mane.
Tom knows that Mary likes him.	Tomas žino, kad patinka Merei.
We have fish for dinner today.	Šiandien vakarienei bus žuvis.
We play soccer every Saturday.	Mes žaidžiame futbolą kiekvieną šeštadienį.
Would you like me to order it?	Ar norėtumėte, kad aš tai užsakyčiau?
Would you like me to order it?	Ar norėtum, kad aš tai užsakyčiau?
You can sit wherever you want.	Galite atsisėsti kur norite.
You can sit wherever you want.	Gali atsisėsti kur nori.
You've been busy, haven't you?	Buvai užimta, ar ne?
A car is faster than a bicycle.	Mašina greitesnė už dviratį.
A century is one hundred years.	Amžius - tai šimtas metų.
All their efforts were in vain.	Visos jų pastangos buvo beprasmiškos.
Are you two traveling together?	Ar judu keliaujate kartu?
Can you really tell the future?	Ar tu tikrai moki pranašauti ateitį?
Don't let him know her address.	Nesakykite jam jos adreso.
Don't step on the broken glass.	Neužlipk ant sudužusio stiklo.
Drop by my office this evening.	Šį vakarą užsuk į mano biurą.
Have you ever seen Tokyo Tower?	Ar kada nors matėte Tokijo bokštą?
He denied having written to me.	Jis paneigė, kad man rašė.
He didn't agree to my proposal.	Jis nesutiko su mano pasiūlymu.
He gave us the signal to begin.	Jis davė mums signalą pradėti.
He likes to work in the garden.	Jis mėgsta dirbti sode.
He likes to work in the garden.	Jis mėgsta sodininkauti.
He threw a stone into the lake.	Jis metė akmenį į ežerą.
I assume you know what this is.	Manau, supranti, kas tai yra.
I can't live like this anymore.	Nebegaliu daugiau taip gyventi.
I could hardly believe my eyes.	Vos galėjau patikėti savo akimis.
I didn't know Tom spoke French.	Nežinojau, kad Tomas kalba prancūziškai.
I didn't play tennis yesterday.	Vakar aš nežaidžiau teniso.
I don't like to make a mistake.	Man nepatinka klysti.
I don't want to read this book.	Aš nenoriu skaityti šios knygos.
I don't want to wait that long.	Aš nenoriu tiek ilgai laukti.
I feel happy when I'm with you.	Jaučiuosi laimingu kai esu su tavimi.
I followed my mother's example.	Aš pasekiau motinos pavyzdžiu.
I forgot to turn off the light.	Pamiršau užgesinti šviesą.
I know you're hiding something.	Žinau, kad kažką slepi.
I want to be a baseball player.	Noriu būti beisbolo žaidėju.
I'm going to try something new.	Aš pabandysiu kažką naujo.
I'm sorry for what I have done.	Atsiprašau už tai, ką padariau.
I'm very happy to have met you.	Esu labai laimingas, kad sutikau tave.
I'm very happy to have met you.	Esu labai laiminga, kad sutikau tave.
In other words, he betrayed us.	Kitaip tariant, jis išdavė mus.
It must be done more carefully.	Tai turi būti daroma atsargiau.
It turned out that I was right.	Pasirodė, kad aš buvau teisus.
It was a very beautiful flower.	Tai buvo labai graži gėlė.
Most Americans like hamburgers.	Dauguma amerikiečių mėgsta mėsainius.
She bought a toy for her child.	Ji nupirko savo vaikui žaislą.
She has already gone to school.	Ji jau išėjo į mokyklą.
She's used to getting up early.	Ji priprato keltis anksti.
That was a valuable experience.	Tai buvo vertinga patirtis.
That's what I don't understand.	Štai ko aš nesuprantu.
The law is full of ambiguities.	Įstatymai pilni dviprasmybių.
The tower stood amid the ruins.	Bokštas stovėjo tarp griuvėsių.
The water here is very shallow.	Vanduo čia labai seklus.
There's no new information yet.	Dar nėra naujos informacijos.
This telephone is out of order.	Šis telefonas neveikia.
This telephone is out of order.	Šis telefonas sugedo.
This train is bound for Boston.	Šis traukinys vyksta į Bostoną.
Tom doesn't want to discuss it.	Tomas nenori to aptarinėti.
Tom goes to bed after midnight.	Tomas eina miegoti po vidurnakčio.
Tom is the captain of the team.	Tomas yra komandos kapitonas.
Tom took his family to the zoo.	Jis nusivedė šeimą į zoologijos sodą.
Tom was alone most of the time.	Tomas dažniausiai buvo vienas.
Tom was killed in a dark alley.	Tomas buvo nužudytas tamsiame skersgatvyje.
We call New York the Big Apple.	Mes vadiname Niujorką Didžiuoju obuoliu.
We have a very serious problem.	Mes turime labai rimtą problemą.
We'll be home all day tomorrow.	Mes rytoj visą dieną būsime namie.
What does he say in his letter?	Ką jis rašo laiške?
When is the ship due to arrive?	Kada turėtų atplaukti laivas?
Where did you sleep last night?	Kur tu miegojai praėjusią naktį?
Where did you sleep last night?	Kur jūs miegojote praėjusią naktį?
You can turn off the radio now.	Tu dabar gali išjungti radiją.
You can turn the radio off now.	Tu dabar gali išjungti radiją.
You're going to ruin your eyes.	Sugadinsi sau akis.
As far as I know, he won't come.	Kiek man žinoma, jis neateis.
Does anyone here speak Japanese?	Ar kas nors čia kalba japoniškai?
Does anyone here speak Japanese?	Ar čia yra mokančių japoniškai?
Everything you've heard is true.	Viskas ką girdėjai yra tiesa.
He believes he knows everything.	Jis mano, kad žino viską.
He denied that he was the thief.	Jis neigė esąs vagis.
He has no friends to advise him.	Jis neturi draugų, kurie jam galėtų patarti.
I am very sorry for what I said.	Aš labai apgailestauju dėl to, ką pasakiau.
I can only tell you what I know.	Galiu tau pasakyti tik tai, ką žinau.
I can show the documents to you.	Aš galiu jums parodyti dokumentus.
I can show the documents to you.	Aš galiu tau parodyti dokumentus.
I drove all the way from Boston.	Atvažiavau iš pat Bostono.
I fell asleep while watching TV.	Aš užmigau žiūrėdamas televizorių.
I gave that order six hours ago.	Aš daviau tą užsakymą prieš šešias valandas.
I have had no news from him yet.	Iš jo dar nėra žinių.
I haven't done this for a while.	Jau kurį laiką to nedariau.
I need to talk to you in person.	Man reikia su tavim pasikalbėti akis į akį.
I never said it would be simple.	Aš niekada nesakiau, kad bus lengva.
I thought you said it was yours.	Maniau, sakiai, kad jis tavo.
I thought you said it was yours.	Maniau, sakiai, kad ji tavo.
I took your umbrella by mistake.	Per klaidą paėmiau tavo skėtį.
I was trying to prove something.	Aš bandžiau kažką įrodyti.
I'm not sure I want to see this.	Nesu tikras, kad noriu tai pamatyti.
I've finished reading that book.	Aš pabaigiau skaityti šią knygą.
If it ain't broke, don't fix it.	Jei nelūžo, netaisyk.
In the winter, days are shorter.	Žiemą dienos trumpesnės.
It is love that rules the world.	Meilė valdo pasaulį.
It is this window that he broke.	Štai tas langas, kurį jis išdaužė.
Let's go talk in the other room.	Eikime pasikalbėti kitame kambaryje.
My dream is to become a teacher.	Mano svajonė yra tapti mokytoju.
She asked me if I was all right.	Ji paklausė, ar man viskas gerai.
She has a cat. The cat is white.	Ji turi katę. Katė yra balta.
That song sounds familiar to me.	Ta daina man skamba pažįstamai.
The girl had a large red hat on.	Mergaitė dėvėjo didžiulę raudoną kepurę.
The moon moves around the earth.	Mėnulis sukasi aplink Žeme.
Today is our last day of school.	Šiandien mums paskutinė diena mokykloje.
Tom and Mary look good together.	Tomas ir Merė kartu gerai atrodo.
Tom couldn't have done it alone.	Tomas negalėjo padaryti to vienas.
Tom didn't have a car back then.	Tuomet Tomas neturėjo automobilio.
Tom hardly ever makes a mistake.	Tomas retai kada padaro klaidą.
Tom is learning to figure skate.	Tomas mokosi dailiojo čiuožimo.
Tom is learning to figure skate.	Tomas mokosi čiuožti ant ledo.
Tom knows that I don't like him.	Tomas žino, kad aš jo nemėgstu.
Tom often writes to his parents.	Tomas dažnai rašo tėvams.
Unlike my brother, I can't swim.	Skirtingai nuo brolio, aš nemoku plaukti.
We ate sandwiches for breakfast.	Pusryčiams mes valgėme sumuštinius.
We eat to live, not live to eat.	Mes valgome, kad gyventume, o negyvename, kad valgytume.
We know that all men are mortal.	Mes žinome, kad visi žmonės yra mirtingi.
We were poor, but we were happy.	Mes buvome skurdūs, bet laimingi.
What time will you be back home?	Kelintą valandą grįši namo?
Why are you giving up so easily?	Kodėl taip lengvai pasiduodate?
Why are you giving up so easily?	Kodėl taip lengvai pasiduodi?
You came at just the right time.	Atėjai pačiu laiku.
Your friend's in the other room.	Tavo draugas yra kitame kambaryje.
A few people came to the lecture.	Keli žmonės atėjo į paskaitą.
A few people came to the lecture.	Keletas žmonių atėjo į paskaitą.
A foolish idea came into my mind.	Man į galvą atėjo kvaila mintis.
A very good thing happened today.	Šiandien įvyko kai kas labai gero.
After the movie they fall asleep.	Po filmo jie užmigo.
Children sometimes lack patience.	Vaikams kartais trūksta kantrybės.
Children sometimes lack patience.	Vaikai kartais būna nekantrūs.
Do you know what Tom was wearing?	Ar tu žinai, ką vilkėjo Tomas?
Do you know what Tom was wearing?	Ar jūs žinote, ką vilkėjo Tomas?
Grab him! Don't let him get away.	Čiupkite jį! Neleiskite jam pasprukti!
He lost his ticket for the movie.	Jis pametė savo bilietą į kiną.
I always get home by six o'clock.	Aš visada ateinu namo prieš šeštą valandą.
I can't imagine life without Tom.	Negaliu įsivaizduoti gyvenimo be Tomo.
I don't usually wait for anybody.	Paprastai aš nieko nelaukiu.
I don't want to go to work today.	Nenoriu eiti dirbti šiandien.
I feel terrible about my mistake.	Jaučiuosi siaubingai dėl savo klaidos.
I haven't seen him in a few days.	Aš nemačiau jo kelias dienas.
I was stranded on a small island.	Aš buvau įstrigęs mažoje saloje.
I went there because I wanted to.	Aš ten nuėjau, nes norėjau.
I will ask him about it tomorrow.	Paklausiu jo apie tai rytoj.
I'm certain that he has finished.	Esu tikras kad jis yra pasiruošęs.
I'm old enough to live by myself.	Esu pakankamai suaugęs, kad gyvenčiau vienas.
I'm old enough to live by myself.	Esu pakankamai suaugusi, kad gyvenčiau viena.
I've already been here two hours.	Aš jau čia dvi valandas.
I've heard quite a lot about you.	Aš esu daug apie tave girdėjęs.
Is it safe to skate on this lake?	Ar saugu čiuožinėti ant šio ežero?
Is this your first time in Japan?	Ar tai tavo pirmas kartas Japonijoje?
Is this your first time in Japan?	Ar tai jūsų pirmas kartas Japonijoje?
It doesn't look like you're busy.	Nepanašu, kad būtum užsiėmęs.
It doesn't look like you're busy.	Nepanašu, kad būtum užsiėmusi.
It doesn't look like you're busy.	Nepanašu, kad būtumėte užsiėmę.
It's pitch black inside the cave.	Uoloje tamsu it naktyje.
My aunt brought up five children.	Mano teta užaugino penkis vaikus.
My eyesight is beginning to fail.	Mano regėjimas pradeda silpti.
Never ever do it like this again.	To daugiau niekada taip nedaryk!
Our cow doesn't give us any milk.	Mūsų karvė visai neduoda pieno.
Saint Peter's Square was crowded.	Švento Petro aikštė buvo pilna žmonių.
She employed him as a programmer.	Ji įdarbino jį programuotoju.
She is poor, but she looks happy.	Ji neturtinga, bet atrodo laiminga.
The phone doesn't work right now.	Telefonas šiuo metu neveikia.
There is nothing wrong with this.	Tame nėra nieko blogo.
There is nothing wrong with this.	Tame nėra nieko neteisingo.
They will get married next month.	Jie susituoks kitą mėnesį.
This is how I solved the problem.	Štai kaip aš išsprendžiau problemą.
Tom and Mary became missionaries.	Tomas ir Marija tapo misionieriais.
Tom has a sister who is a lawyer.	Tomas turi seserį, kuri yra advokatė.
Tom has a sister who is a lawyer.	Tomas turi sesę advokatę.
Tom has agreed to walk Mary home.	Tomas sutiko palydėti Merę namo.
Tom is better at chess than I am.	Tomas žaidžia šachmatais geriau už mane.
Tom knows nothing about politics.	Tomas politikoje nieko neišmano.
Tom thinks he can save the world.	Tomas galvoja, kad gali išgelbėti pasaulį.
Tom's father is a police officer.	Tomo tėvas yra policijos pareigūnas.
We stood face to face with death.	Stovėjome veidu į veidą su mirtimi.
We've got to move very carefully.	Mes turime judėti labai atsargiai.
What are you doing for Halloween?	Ką tu veiki per Heloviną?
What are you doing for Halloween?	Ką jūs veikiate per Heloviną?
You can't live like that anymore.	Jūs negalite daugiau taip gyventi.
You're not going to believe this.	Tu tuo nepatikėsi.
All of a sudden, it began raining.	Nė iš šio nė iš to ėmė lyti.
Are you going to work until 10:00?	Dirbsi iki dešimtos valandos?
Close your eyes, and count to ten.	Užsimerk ir suskaičiuok iki dešimties.
Does anybody else know about this?	Ar dar kas nors apie tai žino?
Don't be afraid to make a mistake.	Nebijok padaryti klaidos.
Don't forget to remind me of that.	Nepamiršk man apie tai priminti.
Halloween's celebrated in October.	Helovinas švenčiamas spalį.
He brought back several souvenirs.	Jis parsivežė suvenyrų.
He did not eat anything yesterday.	Vakar jis nieko nevalgė.
He had nothing to say, so he left.	Jis neturėjo, ką pasakyti, todėl išėjo.
He is unsatisfied with the result.	Jis yra nepatenkintas rezultatu.
He is unsatisfied with the result.	Jis nėra patenkintas rezultatu.
How did you get into the building?	Kaip tu patekai į pastatą?
How did you get into the building?	Kaip jūs patekote į pastatą?
How many hours a week do you work?	Kiek valandų per savaitę dirbate?
I answered all of Tom's questions.	Aš atsakiau į visus Tomo klausimus.
I can't believe I'm actually here.	Aš negaliu patikėti, kad aš iš tiesų esu čia.
I can't say anything at this time.	Dabar nieko negaliu pasakyti.
I didn't understand a single word.	Nesupratau nė žodžio.
I have lived here for a long time.	Aš gyvenu čia jau seniai.
I went to sleep during the lesson.	Aš užmigau per pamoką.
I wouldn't sell that at any price.	Nė už ką to neparduočiau.
I'm taking pictures of the bridge.	Aš darau tilto nuotraukas.
I've been to Boston several times.	Aš keletą kartų buvau Bostone.
Lincoln granted liberty to slaves.	Linkolnas suteikė vergams laisvę.
She has been sick since last week.	Ji serga nuo praeitos savaitės.
Some people think it's a bad idea.	Kai kurie žmonės mano, kad tai yra bloga idėja.
Someone stole my driver's license.	Kažkas pavogė mano vairuotojo pažymėjimą.
Sometimes a cigar is just a cigar.	Kartais cigaras tėra cigaras.
Thank you for this wonderful gift.	Ačiū jums už šią nuostabią dovaną.
The baby can stand but can't walk.	Kūdikis gali stovėti, bet negali vaikščioti.
This town is really dead at night.	Šis miestas naktį būna lyg apmiręs.
Today's meeting has been canceled.	Šiandienos susirinkimas buvo atšauktas.
Today's meeting has been canceled.	Šiandienos susitikimas buvo atšauktas.
Tom doesn't live with his parents.	Tomas negyvena su savo tėvais.
Tom has no objection to your plan.	Tomas neturi prieštaravimų dėl tavo plano.
Tom pretended to be Mary's friend.	Tomas apsimetinėjo Merės draugu.
Tom said the same thing about you.	Tomas apie tave sakė tą patį.
Tom was the only guy in the class.	Tomas buvo vienintelis vaikinas klasėje.
We've never seen anything like it.	Niekada nesame matę nieko panašaus.
Ask him when the next plane leaves.	Paklausk jo, kada išskrenda sekantis lėktuvas.
Could I have another glass of beer?	Ar galėčiau gauti dar vieną taurę alaus?
Don't be scared to meet new people.	Nebijok pažinti naujų žmonių.
Don't be scared to meet new people.	Nebijokite naujų pažinčių.
Don't let the dog sleep in our bed.	Neleisk šuniui miegoti mūsų lovoje.
Don't you want to be in love again?	Argi tu nenori vėl įsimylėti?
He answered that he knew no French.	Jis atsakė nemokąs nė trupučio prancūziškai.
He knows how to interrogate people.	Jis moka tardyti žmones.
He took over his father's business.	Jis perėmė savo tėvo verslą.
His behavior aroused my suspicions.	Jo elgesys sukėlė man įtarimų.
How many close friends do you have?	Kiek artimų draugų tu turi?
How much is the rent for this room?	Kiek kainuoja kambario nuoma?
How much is the rent for this room?	Kokia yra kambario nuomos kaina?
I bought a new computer last month.	Nusipirkau naują kompiuterį praeitą mėnesį.
I don't like living in the country.	Man nepatinka gyventi kaime.
I had the artist paint my portrait.	Užsakiau dailininkui nutapyti savo portretą.
I have no regrets about what I did.	Ne kiek nesigailiu to, ką padariau.
I never had the courage to open it.	Aš niekada neturėjau drąsos tai atidaryti.
I slipped and fell down the stairs.	Aš paslydau ir nukritau nuo laiptų.
I'm bored and I have nothing to do.	Man nuobodu ir nėra ką veikti.
I'm not the only one who likes Tom.	Aš ne vienintelis, mėgstantis Tomą.
I'm not the only one who likes Tom.	Aš ne vienintelė, mėgstanti Tomą.
If you need me, I'll be in my room.	Jei tau manęs reikės, aš būsiu savo kambaryje.
Is there space for one more person?	Ar yra vietos dar vienam žmogui?
It's more difficult than you think.	Tai sudėtingiau, nei tu manai.
It's still too cold to wear shorts.	Per šalta vilkėti šortus.
It's time you went to the barber's.	Tau pats laikas nueiti pas kirpėją.
Last year, there was a bad harvest.	Praeitų metų derlius buvo prastas.
Meetings are held every other week.	Susitikimai vyksta kas antrą savaitę.
My daughter was taken away from me.	Dukra buvo iš manęs atimta.
My sister likes melons and so do I.	Mano sesė mėgsta melionus, ir aš taip pat.
Oh, is that the way you milk a cow?	Ak, tai štai kaip yra melžiama karvė?
She asked me to wake her up at six.	Ji manęs paprašė, kad ją pažadinčiau šeštą.
She complained about my low salary.	Ji skundėsi dėl mano žemo atlyginimo.
Teaching English is his profession.	Anglų kalbos mokymas yra jo profesija.
The dog lying on the grass is mine.	Šuo, gulintis ant žolės, yra mano.
The lion is the king of the jungle.	Liūtas yra džiunglių karalius.
The picture is hanging on the wall.	Paveikslas kabo ant sienos.
There are only two correct answers.	Yra tik du teisingi atsakymai.
There was peace all over the world.	Visame pasaulyje buvo taika.
They stayed in Rome till September.	Jie viešėjo Romoje iki rugsėjo.
This is the tallest tower in Japan.	Tai yra aukščiausias bokštas Japonijoje.
Tom ate the whole pizza by himself.	Tomas suvalgė visą picą vienas.
Tom bought a very expensive camera.	Tomas nusipirko labai brangų fotoaparatą.
Tom can't blame anyone but himself.	Tomas negali kaltinti nieko kito, kaip tik patį save.
Tom couldn't persuade Mary to stay.	Tomui nepavyko įkalbinti Merę likti.
Tom decided not to go to the party.	Tomas nusprendė neiti į vakarėlį.
Tom doesn't want to live like that.	Tomas nenori taip gyventi.
Tom isn't my father. He's my uncle.	Tomas ne mano tėvas. Jis mano dėdė.
Was Tom the one who suggested this?	Ar tai Tomas pasiūlė?
Were they in the library yesterday?	Ar jie vakar buvo bibliotekoje?
A famous architect built this house.	Šį namą pastatė garsus architektas.
At least tell me where you're going.	Bent jau pasakyk man, kur tu eini.
At least tell me where you're going.	Bent jau pasakykite, kur jūs einate.
Can you tell me the way to the bank?	Ar galite man parodyti kelią į banką?
Do you think that Tom is still busy?	Ar manai, kad Tomas vis dar užsiėmęs?
Do you want the rest of my sandwich?	Nori mano sumuštinio likutį?
Don't ask them where they are going.	Neklausk jų, kur jie eina.
Don't ask them where they are going.	Neklauskite jų, kur jie eina.
He doesn't have a job. He's retired.	Jis neturi darbo. Jis pensininkas.
He wants to go to the United States.	Jis nori vykti į Jungtines Valstijas.
His family moved around quite a lot.	Jo šeima daug keliavo.
Hunting is banned in national parks.	Medžioklė uždrausta nacionaliniuose parkuose.
Hurry up, or you'll miss your plane.	Paskubėk, nes pavėluosi į savo lėktuvą.
I assume that you know what this is.	Manau, supranti, kas tai yra.
I borrowed some money from a friend.	Aš pasiskolinau pinigų iš savo draugo.
I can neither confirm nor deny that.	Aš negaliu šito nė patvirtinti, nė paneigti.
I can't believe you're still hungry.	Negaliu patikėti, kad vis dar esi alkanas.
I can't believe you're still hungry.	Negaliu patikėti, kad vis dar esi alkana.
I can't understand his ideas at all.	Aš visai negaliu suprasti jo idėjų.
I didn't want to hurt your feelings.	Nenorėjau užgauti tavo jausmų.
I don't want to read anything today.	Aš šiandien nieko nenoriu skaityti.
I hadn't expected anyone to be home.	Aš nesitikėjau, kad kas nors bus namie.
I left early to catch the first bus.	Aš išėjau anksti, kad pagaučiau pirmą autobusą.
I lost my purse on my way to school.	Aš pamečiau piniginę pakeliui į mokyklą.
I need Tom to know that we love him.	Aš noriu, kad Tomas žinotų, kad mes jį mylime.
I wanted to go back to your village.	Aš norėjau sugrįžti į tavo kaimą.
I wanted to go back to your village.	Aš norėjau sugrįžti į jūsų kaimą.
I warned you not to do so, didn't I?	Juk įspėjau taip nedaryti, argi ne?
I was in bed all day long yesterday.	Vakar visą dieną gulėjau lovoje.
I'm beginning to miss my girlfriend.	Aš pradedu pasiilgti mano merginos.
I've already answered that question.	Aš jau atsakiau į tą klausimą.
It is about time you went to school.	Tau laikas eiti į mokyklą.
My apartment is on the fourth floor.	Mano butas ketvirtame aukšte.
My children were taken away from me.	Mano vaikai buvo iš manęs atimti.
My children were taken away from me.	Mano vaikus atėmė iš manęs.
No one knows if he loves her or not.	Niekas nežino, ar jis ją myli ar ne.
No two snowflakes are exactly alike.	Nėra dviejų vienodų snaigių.
Rome has a lot of ancient buildings.	Romoje daug senovinių pastatų.
She looked pleased with her new job.	Ji atrodė patenkinta savo nauju darbu.
She talked as if she were my mother.	Ji kalbėjo taip, tarsi būtų mano mama.
The bomb will explode in 10 seconds.	Bomba sprogs po dešimties minučių.
The shirt you gave me fit perfectly.	Tavo duoti marškiniai man puikiai tinka.
The shirt you gave me fit perfectly.	Marškiniai, kuriuos davei, man puikiai tinka.
There are a few good hotels in town.	Mieste yra keli geri viešbučiai.
They accused me of taking the money.	Jie apkaltino mane paėmus pinigus.
This bridge was built two years ago.	Šis tiltas buvo pastatytas prieš dvejus metus.
Tom doesn't want to take a walk now.	Tomas dabar nenori eiti pasivaikščioti.
Tom forgot where he put his glasses.	Tomas pamiršo, kur padėjo savo akinius.
We make milk into cheese and butter.	Iš pieno mes gaminame sūrį ir sviestą.
We played golf in spite of the rain.	Mes žaidėme golfą nepaisydami lietaus.
What happens if I press this button?	Kas bus, jeigu paspausiu šį mygtuką?
What happens if I press this button?	Kas atsitiks, jei paspausiu šį mygtuką?
Whatever can go wrong will go wrong.	Kas tik gali pakrypti bloga linkme taip ir pakryps.
You've got to take care of yourself.	Turi rūpintis savimi.
Your brother wasn't at school today.	Tavo brolio šiandien nebuvo mokykloje.
Calm down and begin at the beginning.	Nusiramink ir pradėk nuo pradžių.
I asked Tom to sing my favorite song.	Aš paprašiau Tomo padainuoti mano mėgstamą dainą.
I don't know what I'd do without you.	Nežinau, ką be jūsų daryčiau.
I don't know what I'd do without you.	Nežinau, ką be tavęs daryčiau.
I don't know which of you came first.	Nežinau, kuris iš jūsų dviejų atėjo pirmas.
I gave that book to Tom this morning.	Aš daviau tą knygą Tomui šį rytą.
I have everything I need to be happy.	Aš turiu viską, ko reikia norint būti laimingu.
I made a serious mistake on the test.	Teste padariau rimtą klaidą.
I regret not having taken his advice.	Gailiuosi nepaklausęs jo patarimo.
I will stand by you whatever happens.	Būsiu su tavim kad ir kas benutiktų.
I'm going to Boston for the holidays.	Aš vykstu į Bostoną atostogoms.
I'm much better today than yesterday.	Šiandien aš jaučiuosi daug geriau nei vakar.
I've decided to stop studying French.	Aš nusprendžiau nustoti mokytis prancūzų kalbos.
If you change your mind, let us know.	Jei persigalvosi, pranešk mums.
Mexico is a country in North America.	Meksika yra valstybė Šiaurės Amerikoje.
My brother bought an electric guitar.	Mano brolis nusipirko elektrinę gitarą.
My daughter likes to play with dolls.	Mano dukra mėgsta žaisti su lėlėmis.
My sister often looks after the baby.	Mano sesuo dažnai prižiūri kūdikį.
Nothing is more valuable than health.	Nėra nieko vertingesnio už sveikatą.
School starts in September in Europe.	Europoje mokslo metai mokyklose prasideda rugsėjį.
She has about as many stamps as I do.	Ji turi maždaug tiek pat pašto ženklų, kiek aš.
She's accustomed to getting up early.	Ji priprato keltis anksti.
The sun is setting below the horizon.	Saulė leidžiasi už horizonto.
There are a lot of books in his room.	Jo kambaryje yra daug knygų.
There were no volunteers for the job.	Darbui savanorių nebuvo.
Tom has more money than he can spend.	Tomas turi daugiau pinigų, nei galėtų išleisti.
Tom is thinking of selling his house.	Tomas galvoja parduoti namą.
Tom slipped on the ice and fell down.	Tomas paslydo ant ledo ir parkrito.
Tom usually only reads the headlines.	Paprastai Tomas skaito tik antraštes.
We spent the entire day on the beach.	Praleidome visą dieną pliaže.
We were able to catch the last train.	Mums pavyko spėti į paskutinį traukinį.
What do you want to be in the future?	Kuo noretum tapti ateityje?
You've turned up at the right moment.	Atėjai pačiu laiku.
Your daughter is not a child anymore.	Tavo dukra jau nebe vaikas.
Do you believe in love at first sight?	Ar tikite meile iš pirmo žvilgsnio?
Do you believe in love at first sight?	Ar tiki meile iš pirmo žvilgsnio?
Do you want to be an actor in a movie?	Ar nori būti aktorius filme?
He entered my room without permission.	Jis įėjo į mano kambarį be leidimo.
He's young, but he's very intelligent.	Jis jaunas, bet labai protingas.
I couldn't have done this without you.	Be tavęs aš nebūčiau galėjęs to padaryti.
I didn't notice when he left the room.	Aš nepastebėjau, kada jis paliko kambarį.
I don't know and I don't want to know.	Nežinau ir nenoriu žinoti.
I like to travel and visit new places.	Aš mėgstu keliauti ir lankyti naujas vietas.
I'm tired of living this kind of life.	Aš pavargau nuo tokio gyvenimo.
It is difficult to solve this problem.	Šią problemą sunku išspręsti.
My legs are getting better day by day.	Mano kojos sveiksta su kiekviena diena.
My mother gets up early every morning.	Mano mama kiekvieną rytą keliasi anksti.
My uncle is coming to see us tomorrow.	Rytoj ateina mano dėdė aplankyti mūsų.
She made up her mind to go to America.	Ji nusprendė važiuoti į Ameriką.
She put her CDs in a row on the shelf.	Ji laiko savo CD plokšteles eilėje ant lentynos.
The tea is too strong. Add some water.	Arbata per stipri. Atskiesk ją vandeniu.
Tom couldn't stop thinking about Mary.	Tomas negalėjo liautis galvojęs apie Merę.
Tom couldn't tell the two twins apart.	Tomas negalėjo atskirti dvynių vieno nuo kito.
Tom doesn't understand how this works.	Tomas nesupranta, kaip tai veikia.
Tom doesn't want to wait for anything.	Tomas niekada nenori nieko laukti.
Tom has started looking for a new job.	Tomas pradėjo ieškoti naujo darbo.
Tom still doesn't look too interested.	Tomas vis dar neatrodo susidomėjęs.
We've only been together three months.	Mes buvome kartu tik tris mėnesius.
When Dad came home, I was watching TV.	Kai tėtis atėjo namo, aš žiūrėjau televizorių.
I accept, but only under one condition.	Aš sutinku, bet tik su viena sąlyga.
I dislike living in such a noisy place.	Man nepatinka gyventi tokioje triukšmingoje vietoje.
I don't want to be the bad guy anymore.	Nenoriu daugiau būti blogiečiu.
I saw a light at the end of the tunnel.	Aš pamačiau šviesą tunelio gale.
I'm pretty sure Tom understands French.	Esu gana tikras, kad Tomas supranta prancūziškai.
Is there something you want to tell us?	Ar yra kažkas, ką tu nori mums pasakyti?
It's hard for me to explain my actions.	Man sunku paaiškinti savo veiksmus.
Leave me alone or I'll call the police.	Palik mane ramybėje, arba iškviesiu policiją!
Scotland can be very warm in September.	Rugsėjį Škotijoje gali būti labai šilta.
The explosion shook the whole building.	Sprogimas sudrebino visą pastatą.
The moon is the earth's only satellite.	Mėnulis — vienintelis Žemės palydovas.
The sailors abandoned the burning ship.	Jūreiviai paliko degantį laivą.
The ship sank to the bottom of the sea.	Laivas nugrimzdo į jūros dugną.
They are the people who live next door.	Jie yra žmonės, gyvenantis už gretimų durų.
They live in a new house near the park.	Jie gyvena naujame name prie parko.
This design resembles his earlier work.	Šis dizainas primena jo ankstyvesnįjį kūrinį.
Tom and Mary are about the same height.	Tomas su Merė yra beveik vienodo ūgio.
Tom and Mary bought a home with a pool.	Tomas ir Merė nusipirko namą su baseinu.
Tom came up with an extraordinary idea.	Tomas sumanė nepaprastą idėją.
Tom never said that he wanted to leave.	Tomas niekada nesakė, kad norėjo išvažiuoti.
Tom never visited Mary in the hospital.	Tomas niekada neaplankė Merės ligoninėje.
Tom shouldn't have stolen Mary's money.	Tomui nederėjo vogti Merės pinigų.
Who are you and where do you come from?	Kas tu ir iš kur esi?
"I'll never understand women," said Tom.	"Niekada nesuprasiu moterų", pasakė Tomas.
Did you do something new with your hair?	Ar pasidarei kažką savo plaukams?
Did you do something new with your hair?	Ar padarei kažką su savo plaukais?
I admit I did what I promised not to do.	Aš pripažįstų, kad padariau tai, ko žadėjau nedaryti.
I can't even remember what his name was.	Aš net negaliu prisiminti, kuo jis buvo vardu.
I don't understand how you can say that.	Nesuprantu, kaip tu gali taip sakyti.
I wrote a book, but it wasn't very good.	Aš parašiau knygą, bet ji nebuvo labai gera.
Look at the train going over the bridge.	Pažvelk į per tiltą važiuojantį traukinį.
Many Europeans do not know modern Japan.	Daug europiečių nepažįsta šiuolaikinės Japonijos.
My father died at the age of forty-nine.	Mano tėvas mirė būdamas keturiasdešimt devynerių metų.
She was never to see her children again.	Jai taip ir nebuvo lemta vėl išvysti savo vaikų.
She was never to see her children again.	Vaikų ji taip daugiau ir nebematė.
Stand up and introduce yourself, please.	Prašau atsistoti ir pristatyti save.
There is a good chance that he will win.	Yra didelė tikimybė, kad jis nugalės.
This part of the report may be left out.	Ši pranešimo dalis gali būti praleista.
Tom and Mary both have very few friends.	Tomas ir Merė abudu turi labai mažai draugų.
Tom may not want to go swimming with us.	Tomas gali nenorėti eiti maudytis su mumis.
Tom paid a lot of money for that guitar.	Tomas sumokėjo daug pinigų už šią gitarą.
Are you sure we can't repair this camera?	Ar tu esi tikras, kad mes negalime pataisyti šios kameros?
At the North Pole, there are no penguins.	Šiaurės ašigalyje pingvinų nėra.
Don't count on him to lend you any money.	Nesitikėk, kad jis paskolins tau pinigų.
Don't count on him to lend you any money.	Nedėk vilčių, kad jis paskolins tau pinigų.
I asked her what kind of music she liked.	Aš paklausiau jos, kokią muziką ji mėgsta.
I can read English, but I can't speak it.	Aš moku skaityti angliškai, bet nemoku kalbėti.
I can't believe we're really living here.	Negaliu patikėti, kad mes iš tiesų čia gyvename.
I entered someone else's room by mistake.	Per klaidą įėjau į kažkieno kito kambarį.
I think it's important to tell the truth.	Aš manau, kad yra svarbu pasakyti tiesą.
I think we should discuss this situation.	Manau, mums derėtų aptarti šią situaciją.
I was afraid of getting lost in the dark.	Bijojau pasiklysti tamsoje.
If you were an animal, what would you be?	Jei būtum gyvūnas, kokiu būtum?
Illness prevented her from taking a trip.	Liga sutrukdė jai vykti į kelionę.
Illness prevented her from taking a trip.	Liga sukliudė jos kelionę.
Is there something you're not telling us?	Ar yra kažkas, ko tu nesakai mums?
Is there something you're not telling us?	Ar yra kažkas, ko jūs nesakote mums?
Perhaps she doesn't remember my birthday.	Gal ji pamiršo mano gimtadienį.
That is mine. I don't know where hers is.	Tai mano. Aš nežinau, kur jos.
The war brought their research to an end.	Karas nutraukė jų tyrimą.
Tom always feels happy when he sees Mary.	Tomas visada jaučiasi laimingas, matydamas Merę.
Tom destroyed the children's sand castle.	Tomas sugriovė smėlio pilį, kurį pastatė vaikai.
Tom destroyed the children's sand castle.	Tomas sugriovė vaikų pastatytą smėlio pilį.
Tom has lost interest in studying French.	Tomas prarado interesą mokytis prancūzų kalbos.
Tom noticed that his hands weren't clean.	Tomas pastebėjo, kad jo rankos buvo nešvarios.
Tom said that he doesn't like doing that.	Tomas sakė, kad jam nepatinka tai daryti
Tom wants to see you as soon as possible.	Tomas nori matyti tave kaip galima anksčiau.
Which do you like better, spring or fall?	Kas jums labiau patinka, pavasaris ar ruduo?
Do whatever it is that he tells you to do.	Daryk viską, ką tik jis lieps tau daryti.
Don't tell Tom. I don't want to worry him.	Nesakykite Tomui. Nenoriu jo jaudinti.
How did you learn to speak French so well?	Kaip tu išmokai taip gerai kalbėti prancūziškai?
I am very thankful to you for your advice.	Aš labai dėkingas jums už jūsų patarimą.
I can't leave that document here with you.	Negaliu palikti šio dokumento čia su tavimi.
I heard that Tom doesn't know how to swim.	Girdėjau, kad Tomas nemoka plaukti.
I wish I had treated the girl more kindly.	Gaila, jog nesielgiau su mergaite kiek gražiau.
Many young people in Spain are unemployed.	Daug jaunų žmonių Ispanijoje yra bedarbiai.
Many young people in Spain are unemployed.	Daug jaunų ispanų neturi darbo.
That doesn't mean that I'll stop doing it.	Tai nereiškia, kad nustosiu tai daręs.
That doesn't mean that I'll stop doing it.	Tai nereiškia, kad nustosiu tai dariusi.
That doesn't mean that I'll stop doing it.	Tai nereiškia, kad nustosiu tai daryti.
They might not notice that Tom isn't here.	Gal jie nepastebės, kad Tomo čia nėra.
To look at him, you'd take him for a girl.	Žiūrint į jį, jį galima palaikyti mergaite.
Tom and I have no secrets from each other.	Mes su Tomu neturime jokių paslapčių vienas nuo kito.
Tom didn't want to know about my problems.	Tomas nenorėjo nieko žinoti apie mano problemas.
Tom doesn't know what Mary's shoe size is.	Tomas nežino Merės batų dydžio.
We have little opportunity to use English.	Turime mažai galimybių kalbėti angliškai.
White carpets are very hard to keep clean.	Baltus kilimus sunku išlaikyti švarius.
You should be careful in choosing friends.	Būk atsargus rinkdamasis draugus.
Every year, I buy new notebooks for school.	Aš kasmet perku naujų sąsiuvinių mokyklai.
He gave back all the money he had borrowed.	Jis atidavė visus pinigus, kuriuos buvo pasiskolinęs.
He is working hard to pass the examination.	Jis daug mokosi, kad išlaikytų egzaminą.
He soon accustomed himself to cold weather.	Jis greitai priprato prie šaltų orų.
How much rent do you pay for the apartment?	Kiek tu moki už butą?
How much rent do you pay for the apartment?	Kiek jūs mokate už butą?
I don't understand why you want to do that.	Nesuprantu, kodėl tu tai nori padaryti.
I think we're going to need more umbrellas.	Manau, mums reikės daugiau skėčių.
I thought it was the perfect time to leave.	Aš maniau, kad tai buvo tobulas laikas išeiti.
I've given you everything you've asked for.	Daviau tau viską, ko tu prašei.
It is high time you started a new business.	Pats laikas tau pradėti naują verslą.
It took five minutes to get to the station.	Nueiti į stotį reikėjo penkių minučių.
It was ten degrees below zero this morning.	Šį rytą buvo dešimt laipsnių žemiau nulio.
Life in the country is not always tranquil.	Gyvenimas kaime ne visada būna ramus.
My grandfather can't walk without his cane.	Mano senelis negali vaikščioti be savo lazdos.
Some would say that he's playing with fire.	Kai kurie pasakytų, kad jis žaidžia su ugnimi.
The kids are picking flowers in the garden.	Vaikai skina sode gėles.
Tom can't remember where he put his wallet.	Tomas negali prisiminti, kur padėjo savo piniginę.
Tom has already drunk three cups of coffee.	Tomas jau išgėrė tris puodelius kavos.
Tom objected to being treated like a child.	Tomas protestavo prieš tai, kad su juo buvo elgiamasi kaip su vaiku.
Which do you like better, sushi or tempura?	Kas tau labiau patinka: suši ar tempura?
You should know that I'm in love with Mary.	Turėtum žinoti, kad esu įsimylėjęs Merę.
A man's heart is about as large as his fist.	Žmogaus širdis yra maždaug jo kumščio dydžio.
As you make your bed, so you must lie in it.	Kaip paklosi, taip ir išsimiegosi.
Can you spin a basketball on your fingertip?	Ar tu moki sukti krepšinio kamuolį ant piršto?
Come on. There's someone I want you to meet.	Eime. Noriu tave su kai kuo supažindinti.
Don't go out now. We're about to have lunch.	Neišeik dabar. Mes ruošiamės valgyti pietus.
I am hungry because I did not eat breakfast.	Esu alkanas, nes nepusryčiavau.
I am hungry because I did not eat breakfast.	Esu alkana, nes nepusryčiavau.
I hate the world because the world hates me.	Aš nekenčiu pasaulio, nes pasaulis nekenčia manęs.
I worry about whether I'll be a good father.	Nerimauju, ar man pavyks būti geru tėčiu.
If you have any difficulty, ask me for help.	Jei turėsite kokių nors sunkumų, kreipkitės į mane pagalbos.
It is worth fighting for future generations.	Verta kovoti už ateities kartas.
It's well-known that spiders aren't insects.	Plačiai žinoma, kad vora nėra vabzdžiai.
Lithuania is a member of the European Union.	Lietuva yra Europos Sąjungos narė.
That music is worth listening to many times.	Tos muzikos verta klausytis daug kartų.
The rebels made a barricade across the road.	Sukilėliai pastatė barikadą ant kelio.
The world is changing more and more quickly.	Pasaulis keičiasi vis sparčiau.
They have to be awake by 5:00 a.m. tomorrow.	Jie turi būti atsikėlę rytoj 5 ryto.
Tom falls in love with every woman he meets.	Tomas įsimyli kiekvieną sutiktą moterį.
Tom is the only person who knows about this.	Tomas yra vienintelis asmuo, kuris žino apie tai.
We decorated the Christmas tree with lights.	Mes papuošėme Kalėdų eglutę žiburėliais.
We found a secret passage into the building.	Radome slaptą įėjimą į pastatą.
We have agreed to continue the negotiations.	Mes sutarėme toliau tęsti derybas.
Whatever you may say, you won't be believed.	Nors ir ką tu sakytum, vis tiek tavimi niekas nepatikės.
Which do you like better, apples or bananas?	Ką labiau mėgsti: obuolius ar bananus?
Would you like to come to my parents' house?	Ar tu norėtum ateiti į mano tėvų namą?
Before the race, the runners have to warm up.	Prieš bėgimą bėgikai turi apšilti.
He asked her to stay, but she didn't want to.	Jis paprašė ją pasilikti, bet ji nenorėjo.
He asked her to stay, but she didn't want to.	Jis paprašė ją pasilikti, bet ji nepanoro.
He has just as many books as his father does.	Jis, kaip ir jo tėvas, turi daug knygų.
He restricted his drinking to one beer a day.	Jis apribojo gėrimą iki vieno alaus per dieną.
He would like to know whether you play chess.	Jis norėtų sužinoti, ar žaidi šaškėmis.
I was too embarrassed to look her in the eye.	Man buvo per daug gėda pažiūrėti jai į akis.
It is as clear to me as if it were yesterday.	Man viskas aišku, lyg būtų įvykę vakar.
No matter what game he plays, he always wins.	Kad ir kokį žaidimą jis bežaistų, jis visada laimi.
She made a promise to write to me every week.	Ji pažadėjo rašyti man kiekvieną savaitę.
The hero finally defeated the evil scientist.	Herojus pagaliau įveikė piktąjį mokslininką.
This sentence can be interpreted in two ways.	Šį sakinį galima suprasti dvejopai.
Tom can't say for sure when Mary will arrive.	Tomas negali tikrai pasakyti, kada Merė atvažiuos.
Tom has a bank account in the Cayman Islands.	Tomas turi banko sąskaitą Kaimanų salose.
You can always count on him in any emergency.	Juo galima pasikliauti iškilus bet kokiems sunkumams.
You won't finish today if you just sit there.	Tu nepabaigsi šiandien jei ten tik sėdėsi.
A painter's eyes are his most important tools.	Dailininko akys yra jo svarbiausi įrankiai.
Asia is roughly four times the size of Europe.	Azija yra maždaug keturis kartus didesnė už Europą.
Camels are often used to travel in the desert.	Kupranugariai dažnai naudojami keliaujant dykumose.
Computer supplies are very expensive in Japan.	Kompiuterių priedai Japonijoje labai brangūs.
Dinner will be ready in about fifteen minutes.	Vakarienė bus paruošta po maždaug penkiolikos minučių.
Few people noticed her absence from the party.	Labai mažai žmonių pastebėjo, kad jos nebuvo vakarėlyje.
He cut the advertisement out of the newspaper.	Jis iškirpo skelbimą iš laikraščio.
He did not attend the meeting for that reason.	Dėl to jis nedalyvavo susitikime.
I gave Tom a couple of tickets for my concert.	Aš daviau Tomui porą bilietų į savo koncertą.
I had one beer and pretended to be very drunk.	Aš išgėriau vieną alaus ir apsimečiau labai girtu.
I want to become a TV announcer in the future.	Ateityje aš norėčiau tapti televizijos diktoriumi.
I've learned to live with the pain in my back.	Išmokau gyventi su nugaros skausmais.
It's become dark. Would you turn on the light?	Sutemo. Gal įjungtum šviesą?
Let's stay somewhere with easy airport access.	Apsistokime kur nors, kur būtų geras susisiekimas su oro uostų.
Put that knife down. You're making me nervous.	Padėk peilį į vietą. Nervini mane.
She kissed me on the cheek and said goodnight.	Ji pabučiavo man skruostą ir palinkėjo labos nakties.
The more I think about it, the less I like it.	Kuo daugiau apie tai galvoju, tuo mažiau man tai patinka.
There has been a good apple harvest this year.	Šiemet obuolių derlius buvo gausus.
To the best of my knowledge, he will not come.	Kiek man žinoma, jis neateis.
What is the strangest thing you've ever eaten?	Koks yra keisčiausias dalykas, kurį tau kada nors yra tekę valgyti?
Did Tom forgive you for what you did last week?	Ar Tomas tau atleido už tai, ką tu padarei praeitą savaitę?
Did you have to get up very early this morning?	Ar šįryt tau teko keltis labai anksti?
I have the impression that he knows the secret.	Man susidaro toks įspūdis, kad jis žino paslaptį.
I have the same dictionary as your brother has.	Aš turiu tokį patį žodyną, kaip tavo brolis.
I have to go shopping. I'll be back in an hour.	Turiu nueiti apsipirkti, grįšiu po valandos.
I haven't read the final page of the novel yet.	Dar neperskaičiau paskutinio romano puslapio.
I thought this pair of shoes would last longer.	Aš maniau, kad ši pora batų laikys ilgiau.
I took Tom to my favorite restaurant in Boston.	Aš nusivedžiau Tomą į savo mėgstamiausią restoraną Bostone.
It is not easy to speak naturally on the radio.	Kalbėti radijuje natūraliai nėra lengva.
She said that she gets up at six every morning.	Ji sakė, kad kas rytą keliasi šeštą.
The opposite sides of a rectangle are parallel.	Priešingosios stačiakampio kraštinės yra lygiagrečios.
The shop sells expensive accessories for women.	Parduotuvė prekiauja brangiais aksesuarais moterims.
The sun sank below the horizon and it got dark.	Saulė nusileido už horizonto ir pasidarė tamsu.
There was a large harvest of peaches last year.	Praeitais metais buvo didelis persikų derlius.
Tom spent the last years of his life in Boston.	Tomas paskutinius savo gyvenimo metus praleido Bostone.
We heard the news that you had passed the exam.	Girdėjome naujienas, kad tu išlaikei egzaminą.
He's a man of his word, so you can count on him.	Jis yra žodžio žmogus, tad gali juo pasitikėti.
I can't understand anything that foreigner says.	Aš nieko negaliu suprasti iš to, ką sako užsienietis.
I don't understand a word of what you're saying.	Aš nesuprantu nė žodžio, ką tu sakai.
I overslept and consequently couldn't join them.	Aš pramiegojau ir todėl negalėjau prie jų prisijungti.
I'll take care of your kitten while you're gone.	Tau išvykus prižiūrėsiu tavo kačiuką.
I've always wanted to live in a place like this.	Aš visada norėjau gyventi tokioje vietoje.
I've just now finished doing my French homework.	Ką tik pabaigiau daryti prancūzų kalbos namų darbus.
There are many Japanese restaurants in New York.	Niujorke yra daug japonų restoranų.
They asked us if we knew when the movie started.	Jie mūsų paklausė, ar mes žinome, kada prasidėjo filmas.
This procedure has advantages and disadvantages.	Šis metodas turi savo privalumų ir trūkumų.
This procedure has advantages and disadvantages.	Šis metodas turi savo pliusų ir minusų.
Valencia is famous for its unusual architecture.	Valensija yra garsi savo neįprasta architektūra.
Who will take care of the dog while we are away?	Kas pasirūpins šunimi, kol mes būsime išvykę?
You never can tell what'll happen in the future.	Niekada nežinai, kas atsitiks ateityje.
How many apple trees do you have in your orchard?	Kiek obelų auga tavo sode?
I am entering the cafe to get something to drink.	Užeinu į kavinę ko nors išgerti.
I don't have the slightest intention of retiring.	Neturiu nė menkiausio ketinimo trauktis iš pareigų.
I don't know whether Tom still lives here or not.	Aš nežinau, ar Tomas čia dar gyvena ar ne.
My favorite pastime is strolling along the shore.	Laisvalaikiu labiausiai mėgstu vaikščioti pakrante.
My favorite pastime is strolling along the shore.	Pasivaikščiojimas pakrante - mano mėgstamiausias laisvalaikio praleidimas.
The beach is an ideal place for children to play.	Paplūdimys yra ideali vieta vaikams žaisti.
These problems will be solved in the near future.	Šios bėdos bus išspręstos netolimoje ateityje.
They are sitting in the kitchen and drinking tea.	Jie sėdi virtuvėje ir geria arbatą.
They were sitting on the sofa in our living room.	Jie sėdėjo ant sofos mūsų svetainėje.
Tom closed his eyes tightly and endured the pain.	Tomas stipriai užmerkė savo akis ir ištvėrė skausmą.
You must do the work, even if you do not like it.	Privalai atlikti darbą, net jei tau jis nepatinka.
All of the apples that fall are eaten by the pigs.	Visus nukritusius obuolius suėda kiaulės.
All the members of the committee hate one another.	Visi komiteto nariai nekenčia vienas kito.
He finished drinking one beer and ordered another.	Jis baigė gerti alų ir užsisakė dar vieną.
He looked much better this morning than yesterday.	Šįryt jis atrodė daug geriau nei vakar.
I had enough money saved to buy the guitar I want.	Man užteko sutaupytų pinigų nusipirkti norimą gitarą.
I have an older brother who's the same age as you.	Turiu vyresnįjį brolį, kuris yra tavo metų.
I have an older brother who's the same age as you.	Turiu vyresnįjį brolį, kuris yra tokio pat amžiaus, kaip tu.
If my brother hadn't saved me, I would've drowned.	Jei brolis manęs nebūtų išgelbėjęs, aš būčiau nuskendęs.
The oven's hot so be careful not to burn yourself.	Orkaitė karšta, taigi būk atsargus, kad nenusidegintum.
What's the difference between cabbage and lettuce?	Koks skirtumas tarp kopūsto ir salotų?
Do you think we shouldn't have told Tom about this?	Manai, mums nereikėjo apie tai sakyti Tomui?
New York is one of the largest cities in the world.	Njujorkas yra vienas didžiausių pasaulio miestų.
She spends every Saturday afternoon playing tennis.	Ji praleidžia kiekvieną šeštadienio popietę žaisdama tenisą.
The village is connected with our town by a bridge.	Kaimą su mūsų miestu sujungia tiltas.
Whatever happens happens, I'm not changing my mind.	Kad ir kas atsitiktų, aš nesirengiu keisti savo nuomonės.
Why do you think Tom prefers living in the country?	Kaip tu galvoji, kodėl Tomui labiau patinka gyventi kaime?
My mother bought me a pretty dress this past Sunday.	Praėjusį sekmadienį mano mama man nupirko gražią suknelę.
Tom signed all the documents Mary's lawyer gave him.	Tomas pasirašė visus dokumentus, kuriuos jam davė Merės advokatas.
You only have to stand there without doing anything.	Tu tik turi stovėti ten ir nieko nedaryti.
It's difficult to get the car going on cold mornings.	Sunku užkurti mašiną ryte, kai lauke šalta.
She was over thirty when her artistic talent emerged.	Jai buvo virš trisdešimt, kai atsiskleidė jos talentas.
Tom told Mary not to waste her money on such a thing.	Tomas liepė Merei nešvaistyti pinigų tokiam dalykui.
As soon as he finished eating, he began to walk again.	Vos baigęs valgyti, jis vėl eme vaikščioti.
Back in high school, I got up at 6 a.m. every morning.	Mokydamasis vidurinėje mokykloje aš kasdien keldavausi šeštą valandą ryto.
Back in high school, I got up at 6 a.m. every morning.	Kai aš mokiausi vidurinėje mokykloje, kasdien keldavausi šeštą valandą ryto.
He always speaks to me when he meets me on the street.	Jis visada su manim pasikalba, kai susitinka mane gatvėje.
It is close to seven o'clock. We have to go to school.	Jau beveik septynios valandos. Turime eiti į mokyklą.
She asked him why he was crying, but he didn't answer.	Ji paklausė jo, kodėl jis verkė, bet jis neatsakė.
The bus will arrive at the station in fifteen minutes.	Autobusas atvažiuos į stotį po penkiolikos minučių.
All horses are animals, but not all animals are horses.	Visi arkliai yra gyvūnai, tačiau ne visi gyvūnai yra arkliai.
It's unlikely that a hacker could get into our website.	Mažai tikėtina, jog į mūsų internetinę svetainę galėjo įsibrauti hakeris.
One of my dreams is to one day see the aurora borealis.	Viena mano svajonių - kada nors pamatyti Šiaurės pašvaistę.
Some people are for the plan and others are against it.	Vieni yra už planą, kiti yra prieš jį.
The climate of New Zealand is similar to that of Japan.	Naujosios Zelandijos klimatas panašus į Japonijos.
The man attacked her with the intention of killing her.	Vyras užpuolė ją su ketinimu ją nužudyti.
This dictionary is very expensive, but is worth buying.	Šis žodynas labai brangus, bet jį verta nusipirkti.
We should take off our shoes before entering the house.	Mes turime nusiauti batus prieš įeinant į namą.
Her eyes ran over the list to see if her name was on it.	Ji perbėgo akimis sąrašą, ieškodama jame savo vardo.
Mankind will succeed in using nuclear energy peacefully.	Žmonijai pavyks naudoti branduolinę energiją taikiai.
Now that you know the truth, perhaps you'll feel better.	Galbūt dabar, kai žinai tiesą, tu pasijusi geriau?
Tom doesn't know if Mary will go camping with us or not.	Tomas nežino, ar Merė stovyklaus kartu su mumis ar ne.
Everyone would like to believe that dreams can come true.	Kiekvienas norėtų tikėti, kad svajonės gali išsipildyti.
I was very tired, but I was nevertheless unable to sleep.	Nors buvau pavargęs, bet miegoti negalėjau.
I was very tired, but I was nevertheless unable to sleep.	Nors buvau pavargusi, bet miegoti negalėjau.
My uncle was the only person injured in the car accident.	Mano dėdė buvo vienintelis sužeistas avarijoje.
Please excuse me for calling you so early in the morning.	Atleiskite, kad skambinu taip anksti.
Tom, who had been working all day, wanted to have a rest.	Tomas, kuris dirbo visą dieną, norėjo pailsėti.
You're the only person who ever calls me after 10:00 p.m.	Tu esi vienintelis žmogus, kuris man skambina po dešimtos valandos vakaro.
Do not be shy. Your pronunciation is more or less correct.	Nesidrovėk. Tavo tarimas yra daugmaž teisingas.
Except for Tom, the family was all watching TV in silence.	Išskyrus Tomą, šeima žiūrėjo televizorių tylėdami.
He couldn't sleep because of the noise outside his window.	Dėl triukšmo už lango jis negalėjo miegoti.
If God did not exist, it would be necessary to invent him.	Jei Dievas neegzistuotų, mums tektų jį sukurti.
Mary has nobody to talk with, but she doesn't feel lonely.	Merė neturi su kuo pasikalbėti, bet ji nesijaučia vieniša.
There are more than seven thousand languages in the world.	Pasaulyje yra daugiau nei septyni tūkstančiai kalbų.
Tom told me that he didn't want to come home empty-handed.	Tomas man pasakė, jog nenori grįžti namo tuščiomis rankomis.
How much time does the average teenager watch TV every day?	Kiek laiko kiekvieną dieną vidutinis paauglys žiūri televizorių?
I've got to take my library books back before January 25th.	Turiu grąžinti knygas į biblioteką iki sausio 25 dienos.
In my opinion, it would be difficult to solve this problem.	Mano nuomone, bus sunku išspręsti šią problemą.
The capital of Mexico is the largest city in Latin America.	Meksikos sostinė yra didžiausias miestas Lotynų Amerikoje.
They wanted a wedding picture in front of the Eiffel Tower.	Jie norėjo pasidaryti vestuvinę nuotrauką su Eifelio bokštu fone.
Yesterday was the first time I had spoken to Tom in French.	Vakar pirmą kartą kalbėjau su Tomu prancūziškai.
If you're not too busy, could you help me for just a minute?	Jei nesi labai užsiėmęs, gal galėtum man vieną minutę padėti?
If you're not too busy, could you help me for just a minute?	Jei nesi labai užsiėmus, gal galėtum man vieną minutę padėti?
Please get in touch with me as soon as you arrive in Boston.	Prašau susisiekti su manimi, kuomet atvyksite į Bostoną.
Please get in touch with me as soon as you arrive in Boston.	Prašau susisiekti su manimi, kuomet jūs atvyksite į Bostoną.
The thunderstorm yesterday delayed the delivery of the mail.	Vakarykštė audra atidėjo pašto pristatymą.
I can't go back to Australia. I'm wanted by the police there.	Aš negaliu grįžti atgal į Australiją. Ten manęs ieško policija.
I have a cat and a dog. The cat is black and the dog is white.	Aš turiu katę ir šunį. Katė yra juoda, o šuo yra baltas.
I looked at myself in the mirror and I didn't like what I saw.	Aš pažiūrėjau į save veidrodyje ir man nepatiko tai, ką pamačiau.
Flexibility is one of the many advantages of working from home.	Lankstumas - vienas iš daugelio darbo iš namų privalumų.
Go straight down this street and turn right at the third light.	Eikite šia gatve tiesiai ir prie trečio šviesoforo pasukite į dešinę.
Nothing is more valuable than time, but nothing is less valued.	Nėra nieko brangesnio už laiką, bet niekas nėra mažiau branginama.
"Have you ever been here before?" "No, It's my first time here."	"Ar kada nors čia buvai?" "Ne, dabar pirmas kartas"
I can still remember the time when we went on a picnic together.	Aš ir dabar atsimenu tuos laikus, kai su tavim kartu rengėme iškylas.
Running as fast as she could, she still failed to catch the bus.	Nors ji ir bėgo taip greitai, kaip tik galėjo, į autobusą vis tiek nespėjo.
The older you are, the more difficult it is to learn a language.	Kuo esi vyresnis, tuo sunkiau išmokti kalbą.
Electric power companies are seeking to reduce their use of coal.	Elektros energijos kompanijos siekia mažinti anglies suvartojimą.
You can download audio files by native speakers from our website.	Galite parsisiųsti mūsų svetainės kalbančiųjų gimtąja kalba įrašytus garso failus.
Are you seriously thinking about buying a computer from that store?	Ar rimtai galvoji pirkti kompiuterį šioje parduotuvėje?
I waited for him at the station for an hour, but he didn't show up.	Laukiau jo stotyje valandą laiko, bet jis nepasirodė.
Tom didn't want to see Mary in prison for a crime she didn't commit.	Tomas nenorėjo matyti Merės kalinčios už nusikaltimą, kurio ji nepadarė.
We will be studying at the University of San Francisco in September.	Rugsėjį mes mokysimės San Francisko Universitete.
The best way to learn French is to live in a French-speaking country.	Geriausias būdas išmokti prancūzų kalbą yra pagyventi prancūzakalbėje šalyje.
I will see you on next Tuesday, that is to say, the 10th of September.	Iki pasimatimo kitą ketvirtadienį, kitaip tariant, rugsėjo dešimtą dieną.
Tom always insists that he's right even when we all know that he's wrong.	Tomas visada teigia, kad jis teisus, net jeigu mes visi žinome, kad jis klysta.
I think it's highly unlikely that we'll be able to escape from this prison.	Manau, kad mums vargu ar pavyks pabėgti iš šio kalėjimo.
Tom and Mary are still in their offices. Both of them plan to work late today.	Tomas ir Merė vis dar biure. Šiandien jie abu planuoja dirbti iki vėlumos.
It is said that global warming is directly related to carbon dioxide emissions.	Sakoma, kad globalinis atšilimas yra tiesiogiai susietas su anglies dvideginio emisija.
When my uncle left for America, many people came to see him off at the airport.	Kai mano dėdė vyko į Ameriką, daug žmonių atėjo į oro uostą išlydėti jo.
I'd love to be able to spend more time with you, but I have to get back to work.	Mielai praleisčiau daugiau laiko su tavimi, bet turiu grįžti prie darbo.
I think that for many people learning the trigonometric functions is meaningless.	Aš manau, kad daugumai žmonių mokytis trigonometrines funkcijas yra beprasmiška.
If mankind doesn't take care of the environment, the environment may eliminate mankind.	Jei žmonija nesirūpins aplinka, aplinka gali likviduoti žmoniją.
Happiness depends, not so much on circumstances, as on one's way of looking at one's life.	Laimė priklauso ne tiek nuo išorinių aplinkybių, kiek nuo mūsų požiūrio į gyvenimą.
Before I get out of bed, I spend a little time thinking about what I'll be doing the rest of the day.	Prieš atsikeldamas iš lovos, aš praleidžiu kažkiek laiko galvodamas apie tai, ką veiksiu likusią dienos dalį.
January, February, March, April, May, June, July, August, September, October, November and December are the twelve months of the year.	Metus sudaro dvylika mėnesių: sausis, vasaris, kovas, balandis, gegužė, birželis, liepa, rugpjūtis, rugsėjis, spalis, lapkritis ir gruodis.
